Lfd. Nr.;Stadt;Postleitzahl;Fläche in km;Bevölkerung gesamt;Bevölkerung männlich;Bevölkerung weiblich;Bevölkerung je km2
1;Berlin, Stadt;10178;891,12;3574830;1755700;1819130;4012
2;Hamburg, Freie und Hansestadt;20038;755,3;1810438;886289;924149;2397
3;München, Landeshauptstadt;80331;310,71;1464301;714112;750189;4713
4;Köln, Stadt;50667;405,02;1075935;524790;551145;2657
5;Frankfurt am Main, Stadt;60311;248,31;736414;363754;372660;2966
6;Stuttgart, Landeshauptstadt;70173;207,33;628032;313295;314737;3029
7;Düsseldorf, Stadt;40213;217,41;613230;296231;316999;2821
8;Dortmund, Stadt;44135;280,71;585813;287897;297916;2087
9;Essen, Stadt;45127;210,34;583084;283065;300019;2772
10;Leipzig, Stadt;4109;297,8;571088;280292;290796;1918
11;Bremen, Stadt;28195;326,18;565719;279170;286549;1734
12;Dresden, Stadt;1067;328,48;547172;272398;274774;1666
13;Hannover, Landeshauptstadt;30159;204,3;532864;259559;273305;2608
14;Nürnberg;90403;186,45;511628;248451;263177;2744
15;Duisburg, Stadt;47051;232,8;499845;247099;252746;2147
16;Bochum, Stadt;44787;145,66;364920;177592;187328;2505
17;Wuppertal, Stadt;42275;168,39;352390;172255;180135;2093
18;Bielefeld, Stadt;33602;258,82;333451;161109;172342;1288
19;Bonn, Stadt;53111;141,06;322125;153493;168632;2284
20;Münster, Stadt;48143;303,28;311846;149412;162434;1028
21;Karlsruhe, Stadt;76133;173,42;309999;158207;151792;1788
22;Mannheim, Universitätsstadt;68159;144,97;304781;152203;152578;2102
23;Augsburg;86150;146,87;289584;142033;147551;1972
24;Wiesbaden, Landeshauptstadt;65183;203,93;277619;132595;145024;1361
25;Gelsenkirchen, Stadt;45879;104,94;262528;130776;131752;2502
26;Mönchengladbach, Stadt;41061;170,47;260925;128169;132756;1531
27;Braunschweig, Stadt;38100;192,7;248667;122814;125853;1290
28;Kiel, Landeshauptstadt;24103;118,65;247441;120473;126968;2085
29;Chemnitz, Stadt;9111;221,05;246353;121279;125074;1114
30;Aachen, Stadt;52062;160,85;244951;127246;117705;1523
31;Magdeburg, Landeshauptstadt;39104;201,01;238136;117527;120609;1185
32;Halle (Saale), Stadt;6108;135,02;238005;115198;122807;1763
33;Freiburg im Breisgau, Stadt;79098;153,04;227590;108503;119087;1487
34;Krefeld, Stadt;47803;137,77;226812;110593;116219;1646
35;Lübeck, Hansestadt;23539;214,21;216712;103921;112791;1012
36;Mainz, Stadt;55116;97,73;213528;103861;109667;2185
37;Oberhausen, Stadt;46045;77,09;211382;103720;107662;2742
38;Erfurt, Stadt;99084;269,91;211113;102577;108536;782
39;Rostock, Hansestadt;18055;181,36;207513;102082;105431;1144
40;Kassel, documenta-Stadt;34117;106,78;199062;97228;101834;1864
41;Hagen, Stadt der FernUniversität;58095;160,45;188266;91677;96589;1173
42;Saarbrücken, Landeshauptstadt;66111;167,52;179709;89041;90668;1073
43;Hamm, Stadt;59065;226,43;179571;88209;91362;793
44;Potsdam, Stadt;14461;188,26;171810;83060;88750;913
45;Mülheim an der Ruhr, Stadt;45468;91,28;170936;82431;88505;1873
46;Ludwigshafen am Rhein, Stadt;67059;77,43;166621;82629;83992;2152
47;Oldenburg (Oldenburg), Stadt;26122;103,09;165711;79125;86586;1607
48;Osnabrück, Stadt;49074;119,8;164070;79430;84640;1370
49;Leverkusen, Stadt;51373;78,87;163113;79343;83770;2068
50;Heidelberg, Stadt;69117;108,89;159914;77167;82747;1469
51;Solingen, Klingenstadt;42651;89,54;158908;77127;81781;1775
52;Darmstadt, Wissenschaftsstadt;64283;122,09;157437;80183;77254;1290
53;Herne, Stadt;44623;51,42;156774;76745;80029;3049
54;Neuss, Stadt;41460;99,52;152882;74085;78797;1536
55;Paderborn, Stadt;33098;179,59;148677;73899;74778;828
56;Regensburg;93047;80,85;148638;71800;76838;1838
57;Ingolstadt;85049;133,35;133639;67383;66256;1002
58;Würzburg;97070;87,6;126010;59978;66032;1438
59;Fürth;90762;63,35;125403;61372;64031;1980
60;Offenbach am Main, Stadt;63065;44,89;124589;61529;63060;2775
61;Ulm, Universitätsstadt;89073;118,68;123953;61244;62709;1044
62;Wolfsburg, Stadt;38440;204,61;123909;61644;62265;606
63;Heilbronn, Stadt;74072;99,89;123771;62188;61583;1239
64;Pforzheim, Stadt;75175;98,07;123493;60582;62911;1259
65;Göttingen, Stadt;37083;116,93;119177;57943;61234;1019
66;Bottrop, Stadt;46236;100,61;117409;57195;60214;1167
67;Reutlingen, Stadt;72764;87,04;115006;56748;58258;1321
68;Recklinghausen, Stadt;45657;66,5;114003;55494;58509;1714
69;Koblenz, Stadt;56068;105,25;113605;55055;58550;1079
70;Bremerhaven, Stadt;27576;93,66;113034;56304;56730;1207
71;Bergisch Gladbach, Stadt;51465;83,09;111341;53499;57842;1340
72;Remscheid, Stadt;42853;74,52;110611;54533;56078;1484
73;Jena, Stadt;7743;114,76;110321;54968;55353;961
74;Erlangen;91052;76,96;110238;54603;55635;1432
75;Trier, Stadt;54290;117,07;110111;54231;55880;941
76;Moers, Stadt;47441;67,68;103881;50413;53468;1535
77;Salzgitter, Stadt;38226;224,49;103668;51528;52140;462
78;Siegen, Universitätsstadt;57072;114,69;101863;49735;52128;888
79;Hildesheim, Stadt;31134;92,29;101687;48241;53446;1102
80;Cottbus, Stadt;3046;165,62;100416;49542;50874;606
81;Kaiserslautern, Stadt;67657;139,7;99302;50008;49294;711
82;Gütersloh, Stadt;33330;112,02;98466;48898;49568;879
83;Witten, Stadt;58452;72,4;96781;47105;49676;1337
84;Schwerin, Landeshauptstadt;19053;130,52;95668;46111;49557;733
85;Hanau, Brüder-Grimm-Stadt;63450;76,49;95370;47187;48183;1247
86;Gera, Stadt;7545;152,19;94750;45757;48993;623
87;Iserlohn, Stadt;58636;125,49;93197;45618;47579;743
88;Ludwigsburg, Stadt;71638;43,34;93035;45728;47307;2147
89;Esslingen am Neckar, Stadt;73728;46,43;92186;45838;46348;1986
90;Zwickau, Stadt;8056;102,58;90515;44112;46403;882
91;Düren, Stadt;52349;85;90066;44430;45636;1060
92;Tübingen, Universitätsstadt;72070;108,07;88347;41944;46403;818
93;Flensburg, Stadt;24937;56,74;87432;43617;43815;1541
94;Ratingen, Stadt;40878;88,74;87158;41726;45432;982
95;Gießen, Universitätsstadt;35390;72,55;86543;42316;44227;1193
96;Lünen, Stadt;44532;59,39;86274;42045;44229;1453
97;Villingen-Schwenningen, Stadt;78050;165,5;84070;41274;42796;508
98;Konstanz, Universitätsstadt;78462;54,11;83789;40262;43527;1548
99;Marl, Stadt;45768;87,76;83737;41190;42547;954
100;Worms, Stadt;67547;108,73;82595;40542;42053;760
101;Dessau-Roßlau, Stadt;6844;244,75;82505;40105;42400;337
102;Velbert, Stadt;42551;74,9;81822;39905;41917;1092
103;Minden, Stadt;32423;101,12;81637;40087;41550;807
104;Neumünster, Stadt;24534;71,63;79680;39438;40242;1112
105;Norderstedt, Stadt;22846;58,1;77996;37819;40177;1342
106;Delmenhorst, Stadt;27749;62,45;77045;38169;38876;1234
107;Viersen, Stadt;41747;91,1;76384;36918;39466;838
108;Wilhelmshaven, Stadt;26382;107,07;76201;37511;38690;712
109;Bamberg;96047;54,62;75743;36286;39457;1387
110;Gladbeck, Stadt;45964;35,97;75532;36763;38769;2100
111;Rheine, Stadt;48431;145;75338;37264;38074;520
112;Dorsten, Stadt;46284;171,2;75196;36603;38593;439
113;Marburg, Universitätsstadt;35037;123,92;74675;35645;39030;603
114;Troisdorf, Stadt;53840;62;74616;36507;38109;1203
115;Lüneburg, Hansestadt;21335;70,5;74494;35901;38593;1057
116;Castrop-Rauxel, Stadt;44575;51,68;74004;36011;37993;1432
117;Arnsberg, Stadt;59759;193,72;73990;36405;37585;382
118;Detmold, Stadt;32756;129,39;73899;35557;38342;571
119;Lüdenscheid, Stadt;58507;87,02;73164;35905;37259;841
120;Bayreuth;95444;66,89;73065;35438;37627;1092
121;Brandenburg an der Havel, Stadt;14770;229,72;71664;35380;36284;312
122;Bocholt, Stadt;46395;119,4;71350;34938;36412;598
123;Landshut;84028;65,83;70025;33927;36098;1064
124;Celle, Stadt;29221;176,02;69561;33697;35864;395
125;Aschaffenburg;63739;62,45;69187;33450;35737;1108
126;Lippstadt, Stadt;59555;113,68;67812;33375;34437;596
127;Dinslaken, Stadt;46535;47,66;67726;32808;34918;1421
128;Aalen, Stadt;73430;146,58;67684;33502;34182;462
129;Kempten (Allgäu);87435;63,28;67529;33437;34092;1067
130;Fulda, Stadt;36037;104,04;67466;32968;34498;648
131;Herford, Hansestadt;32052;79,16;66514;32405;34109;840
132;Kerpen, Kolpingstadt;50171;113,96;65568;32252;33316;575
133;Plauen, Stadt;8523;102,11;65049;31647;33402;637
134;Neuwied, Stadt;56564;86,5;64689;31598;33091;748
135;Weimar, Stadt;99423;84,48;64355;31152;33203;762
136;Sindelfingen, Stadt;71063;50,83;64159;31833;32326;1262
137;Rüsselsheim am Main, Stadt;65428;58,29;64022;31833;32189;1098
138;Dormagen, Stadt;41539;85,5;64016;31802;32214;749
139;Neubrandenburg, Stadt;17033;86,11;63794;30942;32852;741
140;Grevenbroich, Stadt;41515;102,41;62977;30558;32419;615
141;Rosenheim;83022;37,22;62672;30760;31912;1684
142;Herten, Stadt;45699;37,33;61461;30039;31422;1646
143;Garbsen, Stadt;30827;79,49;60853;29685;31168;766
144;Wesel, Stadt;46483;122,56;60797;29550;31247;496
145;Schwäbisch Gmünd, Stadt;73525;113,78;60349;29478;30871;530
146;Bergheim, Stadt;50126;96,34;60288;29634;30654;626
147;Friedrichshafen, Stadt;88045;69,93;59611;29586;30025;852
148;Hürth, Stadt;50354;51,22;59272;28985;30287;1157
149;Stralsund, Hansestadt;18439;54,14;59101;29076;30025;1092
150;Offenburg, Stadt;77652;78,37;58736;28811;29925;750
151;Langenfeld (Rheinland), Stadt;40764;41,15;58563;28461;30102;1423
152;Frankfurt (Oder), Stadt;15230;147,85;58193;28116;30077;394
153;Greifswald, Hansestadt;17489;50,81;57985;27932;30053;1141
154;Euskirchen, Stadt;53879;139,49;57241;28074;29167;410
155;Neu-Ulm, GKSt;89231;80,95;56978;28080;28898;704
156;Göppingen, Stadt;73033;59,21;56904;28140;28764;961
157;Unna, Stadt4);59423;88,56;/;/;/;/
158;Hameln, Stadt;31785;102,53;56747;27063;29684;553
159;Stolberg (Rhld.), Kupferstadt;52222;98,48;56366;27937;28429;572
160;Sankt Augustin, Stadt;53757;34,22;56115;27428;28687;1640
161;Eschweiler, Stadt;52249;75,75;56008;27331;28677;739
162;Görlitz, Stadt;2826;67,52;55904;26915;28989;828
163;Hilden, Stadt;40721;25,95;55569;26782;28787;2141
164;Meerbusch, Stadt;40667;64,39;55091;26219;28872;856
165;Waiblingen, Stadt;71332;42,75;54824;26866;27958;1282
166;Hattingen, Stadt;45525;71,66;54744;26581;28163;764
167;Baden-Baden, Stadt;76530;140,19;54307;25920;28387;387
168;Lingen (Ems), Stadt;49808;176,19;53905;26677;27228;306
169;Pulheim, Stadt;50259;72,15;53834;25981;27853;746
170;Bad Salzuflen, Stadt;32105;100,05;53746;25803;27943;537
171;Bad Homburg v. d. Höhe, Stadt;61348;51,16;53707;25444;28263;1050
172;Langenhagen, Stadt;30853;71,97;53514;26236;27278;744
173;Menden (Sauerland), Stadt;58706;86,1;53315;26180;27135;619
174;Nordhorn, Stadt;48529;149,87;53286;26280;27006;356
175;Neustadt an der Weinstraße, Stadt;67433;117,09;53209;25873;27336;454
176;Ahlen, Stadt;59227;123,13;52905;25899;27006;430
177;Schweinfurt;97421;35,7;52724;25637;27087;1477
178;Wetzlar, Stadt;35578;75,67;52446;25250;27196;693
179;Wolfenbüttel, Stadt;38300;78,74;52446;25858;26588;666
180;Frechen, Stadt;50226;45,06;52171;25422;26749;1158
181;Goslar, Stadt;38640;163,88;51439;25061;26378;314
182;Ibbenbüren, Stadt;49477;108,87;51289;25320;25969;471
183;Passau;94032;69,56;51074;24380;26694;734
184;Kleve, Stadt;47533;97,76;51047;25249;25798;522
185;Willich, Stadt;47877;67,8;50932;24904;26028;751
186;Speyer, Stadt;67346;42,71;50551;24413;26138;1183
187;Emden, Stadt;26721;112,34;50486;25205;25281;449
188;Gummersbach, Stadt;51643;95,42;50368;24849;25519;528
189;Ravensburg, Stadt;88212;92,05;50095;24683;25412;544
190;Bad Kreuznach, Stadt;55545;55,56;50034;23729;26305;901
191;Peine, Stadt;31224;119,84;49676;24507;25169;415
192;Böblingen, Stadt;71032;39,04;49611;24416;25195;1271
193;Erftstadt, Stadt;50374;119,89;49513;24033;25480;413
194;Elmshorn, Stadt;25335;21,37;49206;24084;25122;2303
195;Lörrach, Stadt;79539;39,37;49153;23676;25477;1249
196;Bad Oeynhausen, Stadt;32545;64,83;48846;23855;24991;754
197;Heidenheim an der Brenz, Stadt;89522;107,09;48709;24145;24564;455
198;Cuxhaven, Stadt;27472;161,92;48551;23048;25503;300
199;Bergkamen, Stadt;59192;44,9;48543;23947;24596;1081
200;Rheda-Wiedenbrück, Stadt;33378;86,72;48526;24273;24253;560
201;Rastatt, Stadt;76437;58,98;48494;23980;24514;822
202;Frankenthal (Pfalz), Stadt;67227;43,88;48445;23483;24962;1104
203;Freising, GKSt;85354;88,59;47848;24051;23797;540
204;Bornheim, Stadt;53332;82,69;47749;23342;24407;577
205;Leonberg, Stadt;71229;48,73;47744;23707;24037;980
206;Singen (Hohentwiel), Stadt;78224;61,77;47603;23154;24449;771
207;Soest, Stadt;59494;85,81;47436;22876;24560;553
208;Gronau (Westf.), Stadt;48599;78,82;47287;23547;23740;600
209;Hennef (Sieg), Stadt;53773;105,89;47237;23043;24194;446
210;Stade, Hansestadt;21682;110,07;47194;23073;24121;429
211;Straubing;94315;67,59;47142;23683;23459;697
212;Dachau, GKSt;85221;34,96;46914;23000;23914;1342
213;Neunkirchen, Kreisstadt;66538;75,26;46816;23072;23744;622
214;Schwerte, Hansestadt an der Ruhr;58239;56,23;46754;22810;23944;832
215;Alsdorf, Stadt;52477;31,68;46712;23160;23552;1475
216;Herzogenrath, Stadt;52134;33,38;46612;22692;23920;1396
217;Dülmen, Stadt;48249;184,83;46523;22627;23896;252
218;Wittenberg, Lutherstadt;6886;240,41;46276;22320;23956;192
219;Melle, Stadt;49324;253,95;46228;22900;23328;182
220;Landau in der Pfalz, Stadt;76829;82,94;46006;21759;24247;555
221;Oberursel (Taunus), Stadt;61440;45,37;45849;22195;23654;1011
222;Lahr/Schwarzwald, Stadt;77933;69,84;45784;22740;23044;656
223;Bünde, Stadt;32257;59,3;45639;22245;23394;770
224;Fellbach, Stadt;70734;27,71;45438;22007;23431;1640
225;Filderstadt, Stadt;70794;38,55;45389;22513;22876;1177
226;Hof;95028;58,02;45183;21631;23552;779
227;Gotha, Stadt;99867;69,58;45172;22206;22966;649
228;Weinheim, Stadt;69469;58,11;44954;21954;23000;774
229;Albstadt, Stadt;72458;134,4;44696;22020;22676;333
230;Rodgau, Stadt;63110;65,04;44465;22086;22379;684
231;Erkrath, Fundort des Neanderthalers, Stadt;40699;26,88;44413;21369;23044;1652
232;Brühl, Stadt;50321;36,12;44294;21130;23164;1226
233;Bruchsal, Stadt;76646;93,19;44266;22208;22058;475
234;Rottenburg am Neckar, Stadt;72108;142,26;44203;22135;22068;311
235;Oranienburg, Stadt;16515;163,66;44079;21618;22461;269
236;Neustadt am Rübenberge, Stadt;31535;358,96;43902;21771;22131;122
237;Lehrte, Stadt;31275;127,67;43720;21685;22035;342
238;Kamen, Stadt;59174;40,95;43672;21423;22249;1066
239;Erkelenz, Stadt;41812;117,34;43388;21204;22184;370
240;Memmingen;87700;70,11;43293;21331;21962;617
241;Kaarst, Stadt;41564;37,39;43218;20748;22470;1156
242;Kaufbeuren;87600;40,02;43134;21192;21942;1078
243;Falkensee, Stadt;14612;43,27;43105;21107;21998;996
244;Bietigheim-Bissingen, Stadt;74321;31,29;43068;21239;21829;1376
245;Wismar, Hansestadt;23952;41,72;42992;21023;21969;1031
246;Halberstadt, Stadt;38820;142,98;42980;22117;20863;301
247;Pinneberg, Stadt;25421;21,54;42638;20701;21937;1979
248;Eisenach, Stadt;99817;104,17;42588;20969;21619;409
249;Weiden i.d.OPf.;92637;70,57;42494;20457;22037;602
250;Borken, Stadt;46325;152,97;42388;20838;21550;277
251;Amberg;92224;50,13;42348;20901;21447;845
252;Nordhausen, Stadt;99734;105,62;42129;20660;21469;399
253;Nettetal, Stadt;41334;83,87;42093;20804;21289;502
254;Homburg, Kreisstadt;66424;82,61;42040;20562;21478;509
255;Gifhorn, Stadt;38518;105,39;42019;20753;21266;399
256;Aurich, Stadt;26603;197,29;41793;20579;21214;212
257;Freiberg, Stadt, Universitätsstadt;9599;48,32;41642;20955;20687;862
258;Ansbach;91522;99,91;41532;19885;21647;416
259;Wunstorf, Stadt;31515;125,74;41478;20210;21268;330
260;Heinsberg, Stadt;52525;92,21;41471;20386;21085;450
261;Laatzen, Stadt;30880;34,16;41389;20031;21358;1212
262;Lemgo, Stadt;32657;100,85;41087;20309;20778;407
263;Coburg;96450;48,29;41071;19929;21142;851
264;Dreieich, Stadt;63303;53,3;41042;20125;20917;770
265;Siegburg, Stadt;53721;23,66;41034;20149;20885;1734
266;Königswinter, Stadt;53639;76,17;40927;19936;20991;537
267;Monheim am Rhein, Stadt;40789;23,05;40814;19633;21181;1771
268;Nürtingen, Stadt;72622;46,88;40752;20364;20388;869
269;Schwabach;91126;40,8;40707;19821;20886;998
270;Weißenfels, Stadt;6667;113,55;40671;20632;20039;358
271;Pirmasens, Stadt;66953;61,36;40416;19684;20732;659
272;Bensheim, Stadt;64625;57,83;40168;19662;20506;695
273;Stendal, Hansestadt;39576;268,02;40164;19671;20493;150
274;Kirchheim unter Teck, Stadt;73230;40,47;40130;19826;20304;991
275;Germering, GKSt;82110;21,6;40039;19296;20743;1853
276;Buxtehude, Hansestadt;21614;76,69;40033;19907;20126;522
277;Eberswalde, Stadt;16225;93,64;40019;19708;20311;427
278;Bautzen, Stadt;2625;66,69;39963;19425;20538;599
279;Bitterfeld-Wolfen, Stadt;6766;86,96;39843;19252;20591;458
280;Löhne, Stadt;32584;59,51;39767;19457;20310;668
281;Leinfelden-Echterdingen, Stadt;70771;29,89;39688;19732;19956;1328
282;Völklingen, Stadt;66333;67,1;39574;19277;20297;590
283;Neumarkt i.d.OPf., GKSt;92318;79,01;39573;19306;20267;501
284;Schorndorf, Stadt;73614;56,83;39520;19385;20135;695
285;Hofheim am Taunus, Kreisstadt;65719;57,38;39517;19265;20252;689
286;Hückelhoven, Stadt;41836;61,27;39423;19502;19921;643
287;Freital, Stadt;1705;40,45;39361;19177;20184;973
288;Ettlingen, Stadt;76275;56,75;39332;19208;20124;693
289;Schwäbisch Hall, Stadt;74523;104,24;39328;19058;20270;377
290;Ahaus, Stadt;48683;151,24;39314;19651;19663;260
291;Ostfildern, Stadt;73760;22,81;38835;19188;19647;1702
292;Würselen, Stadt;52146;34,39;38823;19033;19790;1129
293;Maintal, Stadt;63477;32,4;38739;19085;19654;1196
294;Mettmann, Stadt;40822;42,56;38734;18661;20073;910
295;Buchholz in der Nordheide, Stadt;21244;74,76;38689;18512;20177;518
296;Pirna, Stadt;1796;53,06;38187;18556;19631;720
297;Haltern am See, Stadt;45721;159,03;37893;18455;19438;238
298;Niederkassel, Stadt;53859;35,79;37828;18674;19154;1057
299;Bernau bei Berlin, Stadt;16321;104,17;37725;18378;19347;362
300;Neu-Isenburg, Stadt;63263;24,31;37563;18508;19055;1545
301;Kamp-Lintfort, Stadt;47475;63,14;37414;18402;19012;593
302;Langen (Hessen), Stadt;63225;29,12;37252;18343;18909;1279
303;Fürstenfeldbruck, GKSt;82256;32,53;37176;18425;18751;1143
304;Warendorf, Stadt;48231;176,88;37127;18041;19086;210
305;Greven, Stadt;48268;140,26;37097;18318;18779;264
306;Beckum, Stadt;59269;111,46;36729;18170;18559;330
307;Papenburg, Stadt;26871;118,44;36698;18645;18053;310
308;Backnang, Stadt;71522;39,38;36633;18172;18461;930
309;Königs Wusterhausen, Stadt;15711;96,04;36468;17909;18559;380
310;Coesfeld, Stadt;48653;141,36;36374;17907;18467;257
311;Erding, GKSt;85435;54,61;36291;17565;18726;665
312;Emsdetten, Stadt;48282;72,06;36288;18025;18263;504
313;Voerde (Niederrhein), Stadt;46562;53,49;36273;17748;18525;678
314;St. Ingbert, Stadt;66386;49,95;36069;17305;18764;722
315;Wesseling, Stadt;50389;23,37;35768;17691;18077;1530
316;Porta Westfalica, Stadt;32457;105,22;35698;17648;18050;339
317;Suhl, Stadt;98527;103,03;35608;17337;18271;346
318;Sinsheim, Stadt;74889;126,99;35410;17681;17729;279
319;Kehl, Stadt;77694;75,07;35391;17487;17904;471
320;Lage, Stadt;32791;76,04;35099;17317;17782;462
321;Tuttlingen, Stadt;78532;90,45;34946;17378;17568;386
322;Meppen, Stadt;49716;188,4;34935;17210;17725;185
323;Kempen, Stadt;47906;68,8;34865;16997;17868;507
324;Saarlouis, Kreisstadt;66740;43,28;34849;16960;17889;805
325;Limburg a.d. Lahn, Kreisstadt;65549;45,15;34808;17183;17625;771
326;Wermelskirchen, Stadt;42929;74,8;34638;16917;17721;463
327;Datteln, Stadt;45711;66,1;34555;16930;17625;523
328;Zweibrücken, Stadt;66482;70,64;34428;17012;17416;487
329;Winsen (Luhe), Stadt;21423;109,79;34284;16838;17446;312
330;Cloppenburg, Stadt;49661;70,86;34216;16825;17391;483
331;Mörfelden-Walldorf, Stadt;64546;44,15;34135;17211;16924;773
332;Leer (Ostfriesland), Stadt;26789;70,11;34129;17008;17121;487
333;Viernheim, Stadt;68519;48,4;34100;16734;17366;705
334;Merseburg, Stadt;6217;53,76;33931;16526;17405;631
335;Barsinghausen, Stadt;30890;102,81;33922;16739;17183;330
336;Dietzenbach, Kreisstadt;63128;21,67;33903;16934;16969;1564
337;Radebeul, Stadt;1445;26,14;33826;16333;17493;1294
338;Hemer, Stadt4);58675;67,66;/;/;/;/
339;Geldern, Stadt;47608;96,97;33778;16901;16877;348
340;Seelze, Stadt;30926;54,08;33763;16704;17059;624
341;Balingen, Stadt;72336;90,32;33750;16407;17343;374
342;Crailsheim, Stadt;74564;109,08;33735;16962;16773;309
343;Goch, Stadt;47574;115,43;33701;16885;16816;292
344;Uelzen, Hansestadt;29525;136,84;33633;16338;17295;246
345;Steinfurt, Stadt;48565;111,67;33633;16678;16955;301
346;Hoyerswerda, Stadt;2977;95,53;33552;16132;17420;351
347;Bernburg (Saale), Stadt;6406;113,48;33536;16409;17127;296
348;Kornwestheim, Stadt;70806;14,65;33502;16599;16903;2287
349;Bad Vilbel, Stadt;61118;25,68;33458;16229;17229;1303
350;Wedel, Stadt;22880;33,82;33322;16155;17167;985
351;Mühlhausen/Thüringen, Stadt;99974;86,74;33214;16080;17134;383
352;Korschenbroich, Stadt;41352;55,26;32947;16040;16907;596
353;Ahrensburg, Stadt;22926;35,3;32936;15630;17306;933
354;Wernigerode, Stadt;38855;170,18;32911;15624;17287;193
355;Rheinfelden (Baden), Stadt;79618;62,82;32804;16069;16735;522
356;Altenburg, Stadt;4600;45,69;32788;15888;16900;718
357;Naumburg (Saale), Stadt;6618;129,9;32784;15889;16895;252
358;Deggendorf, GKSt;94469;77,14;32782;16090;16692;425
359;Biberach an der Riß, Stadt;88400;72,15;32704;16108;16596;453
360;Lampertheim, Stadt;68623;72,28;32554;16113;16441;450
361;Jülich, Stadt;52428;90,39;32454;16197;16257;359
362;Vechta, Stadt;49377;87,88;32179;15943;16236;366
363;Fürstenwalde/Spree, Stadt;15517;70,68;32025;15884;16141;453
364;Delbrück, Stadt;33129;157,28;31949;16295;15654;203
365;Forchheim, GKSt;91301;44,45;31942;15366;16576;719
366;Bad Nauheim, Stadt;61231;32,54;31924;15040;16884;981
367;Itzehoe, Stadt;25524;28,03;31896;15266;16630;1138
368;Georgsmarienhütte, Stadt;49124;55,45;31594;15471;16123;570
369;Oer-Erkenschwick, Stadt;45739;38,66;31569;15639;15930;817
370;Achim, Stadt;28832;68,06;31422;15276;16146;462
371;Rheinberg, Stadt;47495;75,24;31356;15353;16003;417
372;Nienburg (Weser), Stadt;31582;64,53;31354;15205;16149;486
373;Herrenberg, Stadt;71083;65,7;31253;15275;15978;476
374;Bramsche, Stadt;49565;183,39;31110;15799;15311;170
375;Kreuztal, Stadt;57223;71,07;31082;15409;15673;437
376;Einbeck, Stadt;37574;231,92;31076;15156;15920;134
377;Schönebeck (Elbe), Stadt;39218;86,02;31063;15010;16053;361
378;Geestland, Stadt;27607;356,83;31040;15136;15904;87
379;Neuruppin, Stadt;16816;305,25;31037;15208;15829;102
380;Gevelsberg, Stadt;58285;26,34;30966;15076;15890;1176
381;Riesa, Stadt;1589;58,91;30894;14992;15902;524
382;Emmerich am Rhein, Stadt;46446;80,4;30852;15583;15269;384
383;Werl, Stadt;59457;76,35;30843;15776;15067;404
384;Radolfzell am Bodensee, Stadt;78315;58,55;30784;14897;15887;526
385;Geesthacht, Stadt;21502;33,25;30453;14917;15536;916
386;Haan, Stadt;42781;24,19;30414;14574;15840;1257
387;Osterholz-Scharmbeck, Stadt;27711;147,17;30398;14921;15477;207
388;Lohmar, Stadt;53797;65,62;30395;14968;15427;463
389;Burgdorf, Stadt;31303;112,56;30320;14872;15448;269
390;Schwedt/Oder, Stadt;16303;205,56;30182;14509;15673;147
391;Weil am Rhein, Stadt;79576;19,46;30164;14621;15543;1550
392;Meschede, Kreis- und  Hochschulstadt;59872;218,5;30081;14893;15188;138
393;Ennepetal, Stadt der Kluterthöhle;58256;57,77;29901;14581;15320;518
394;Werne, Stadt;59368;76,14;29858;14488;15370;392
395;Merzig, Kreisstadt;66663;108,98;29812;14742;15070;274
396;Andernach, Stadt;56626;53,34;29679;14389;15290;556
397;Bad Hersfeld, Kreisstadt;36251;73,82;29615;14477;15138;401
398;Neuburg a.d.Donau, GKSt;86633;81,29;29587;14908;14679;364
399;Friedberg, St;86316;81,25;29510;14438;15072;363
400;Taunusstein, Stadt;65232;67,03;29470;14278;15192;440
401;Rietberg, Stadt;33397;110,31;29444;14861;14583;267
402;Höxter, Stadt;37671;158,16;29420;14564;14856;186
403;Gaggenau, Stadt;76571;65,01;29315;14406;14909;451
404;Oelde, Stadt;59302;102,77;29265;14670;14595;285
405;Waltrop, Stadt;45731;47,09;29245;14195;15050;621
406;Tönisvorst, Stadt;47918;44,34;29235;14239;14996;659
407;Güstrow, Stadt;18273;71,09;29215;14139;15076;411
408;Vaihingen an der Enz, Stadt;71665;73,4;29041;14469;14572;396
409;Northeim, Stadt;37154;145,85;28966;14163;14803;199
410;Bretten, Stadt;75015;71,1;28959;14416;14543;407
411;Bühl, Stadt;77815;73,18;28903;14186;14717;395
412;Zeitz, Stadt;6712;87,18;28826;13988;14838;331
413;Landsberg am Lech, GKSt;86899;57,91;28824;14395;14429;498
414;Springe, Stadt;31832;160,12;28807;13976;14831;180
415;Rösrath, Stadt;51503;38,8;28778;14126;14652;742
416;Unterschleißheim, St;85716;14,93;28761;14509;14252;1927
417;Kelkheim (Taunus), Stadt;65779;30,65;28691;14079;14612;936
418;Schwandorf, GKSt;92421;123,81;28621;14291;14330;231
419;Friedberg (Hessen), Kreisstadt;61169;50,17;28596;14279;14317;570
420;Schwelm, Stadt;58332;20,49;28477;13722;14755;1390
421;Idar-Oberstein, Stadt;55743;91,58;28373;13880;14493;310
422;Grimma, Stadt;4668;218,25;28322;13952;14370;130
423;Kevelaer, Stadt;47623;100,64;28287;13916;14371;281
424;Rendsburg, Stadt;24768;23,73;28190;13926;14264;1188
425;Wegberg, Stadt;41844;84,34;28165;13886;14279;334
426;Winnenden, Stadt;71364;28,05;28152;13956;14196;1004
427;Mühlheim am Main, Stadt;63165;20,67;28130;13925;14205;1361
428;Leichlingen (Rheinland), Blütenstadt;42799;37,26;28101;13546;14555;754
429;Sundern (Sauerland), Stadt;59846;193,27;28000;14069;13931;145
430;Meißen, Stadt;1662;30,92;27984;13481;14503;905
431;Bad Neuenahr-Ahrweiler, Stadt;53474;63,38;27844;13005;14839;439
432;Wetter (Ruhr), Stadt;58300;31,55;27785;13680;14105;881
433;Königsbrunn, St;86343;18,4;27780;13727;14053;1510
434;Aschersleben, Stadt;6449;156,22;27751;13399;14352;178
435;Baunatal, Stadt;34225;38,26;27704;13408;14296;724
436;Rödermark, Stadt;63322;29,99;27579;13468;14111;920
437;Geislingen an der Steige, Stadt;73312;75,83;27550;13744;13806;363
438;Verden (Aller), Stadt;27283;71,7;27539;13341;14198;384
439;Emmendingen, Stadt;79312;33,78;27511;13301;14210;814
440;Reinbek, Stadt;21465;31,23;27366;13460;13906;876
441;Olching, St;82140;29,92;27345;13332;14013;914
442;Hattersheim am Main, Stadt;65795;15,81;27312;13634;13678;1727
443;Sangerhausen, Stadt;6526;207,66;27265;13363;13902;131
444;Mechernich, Stadt;53894;136,48;27235;13616;13619;200
445;Rheinbach, Stadt;53359;69,72;27217;13530;13687;390
446;Neukirchen-Vluyn, Stadt;47506;43,5;27200;13174;14026;625
447;Wangen im Allgäu, Stadt;88239;101,35;27135;13207;13928;268
448;Overath, Stadt;51491;68,88;27118;13375;13743;394
449;Griesheim, Stadt;64347;21,55;27103;13567;13536;1258
450;Leimen, Stadt;69181;20,64;27076;13297;13779;1312
451;Baesweiler, Stadt;52499;27,76;27029;13197;13832;974
452;Geilenkirchen, Stadt;52511;83,2;26991;13415;13576;324
453;Hamminkeln, Stadt;46499;164,53;26808;13396;13412;163
454;Schloß Holte-Stukenbrock, Stadt;33758;67,52;26770;13170;13600;396
455;Weinstadt, Stadt;71384;31,71;26750;13144;13606;844
456;Wiesloch, Stadt;69168;30,24;26542;13194;13348;878
457;Lohne (Oldenburg), Stadt;49393;91,11;26447;13495;12952;290
458;Strausberg, Stadt;15344;67,95;26387;12698;13689;388
459;Neckarsulm, Stadt;74172;24,94;26379;13106;13273;1058
460;Lauf a.d.Pegnitz, St;91207;59,77;26378;12860;13518;441
461;Eisenhüttenstadt, Stadt;15890;63,47;26325;12771;13554;415
462;Nordenham, Stadt;26954;87,77;26294;13059;13235;300
463;Köthen (Anhalt), Stadt;6366;78,44;26281;12841;13440;335
464;Staßfurt, Stadt;39418;146,71;26173;12734;13439;178
465;Hennigsdorf, Stadt;16761;31,47;26139;12816;13323;831
466;St. Wendel, Kreisstadt;66606;113,53;26106;12808;13298;230
467;Heiligenhaus, Stadt;42579;27,52;26010;12742;13268;945
468;Ilmenau, Stadt;98693;62,73;25946;13484;12462;414
469;Remseck am Neckar, Stadt;71686;22,82;25876;12761;13115;1134
470;Butzbach, Friedrich-Ludwig-Weidig-Stadt;35510;106,6;25866;12889;12977;243
471;Kulmbach, GKSt;95326;92,77;25853;12498;13355;279
472;Mühlacker, Stadt;75417;54,32;25804;12817;12987;475
473;Ehingen (Donau), Stadt;89584;178,33;25796;13044;12752;145
474;Lennestadt, Stadt;57368;135,59;25755;12957;12798;190
475;Heppenheim (Bergstraße), Kreisstadt;64646;52,14;25725;12726;12999;493
476;Zittau, Stadt;2763;66,75;25723;12564;13159;385
477;Selm, Stadt;59379;60,41;25714;12525;13189;426
478;Bad Honnef, Stadt;53604;48,17;25705;12349;13356;534
479;Hohen Neuendorf, Stadt;16540;48,56;25696;12470;13226;529
480;Teltow, Stadt;14513;21,6;25667;12605;13062;1188
481;Brilon, Stadt;59929;229,16;25611;12541;13070;112
482;Weiterstadt, Stadt;64331;34,4;25572;12936;12636;743
483;Lübbecke, Stadt;32312;65,04;25555;12413;13142;393
484;Plettenberg, Stadt;58840;96,76;25528;12728;12800;264
485;Rinteln, Stadt;31737;109,02;25527;12517;13010;234
486;Zirndorf, St;90513;28,79;25515;12310;13205;886
487;Verl, Stadt;33415;71,37;25465;13019;12446;357
488;Bingen am Rhein, Stadt;55411;37,71;25435;12518;12917;674
489;Pfaffenhofen a.d.Ilm, St;85276;92,64;25409;12663;12746;274
490;Werder (Havel), Stadt;14542;117,05;25345;12508;12837;217
491;Petershagen, Stadt;32469;211,94;25335;12752;12583;120
492;Achern, Stadt;77855;65,24;25319;12563;12756;388
493;Friedrichsdorf, Stadt;61381;30,16;25284;12472;12812;838
494;Lindau (Bodensee), GKSt;88131;33,06;25249;12111;13138;764
495;Ludwigsfelde, Stadt;14974;109,98;25245;12479;12766;230
496;Rottweil, Stadt;78628;71,76;25200;12395;12805;351
497;Norden, Stadt;26506;106,32;25195;12270;12925;237
498;Wiehl, Stadt;51674;53,26;25177;12212;12965;473
499;Salzkotten, Stadt;33154;109,8;25106;12421;12685;229
500;Roth, St;91154;96,33;25102;12245;12857;261
501;Warstein, Stadt;59581;158,03;25041;12525;12516;158
502;Sprockhövel, Stadt;45549;47,94;25032;12074;12958;522
503;Bad Oldesloe, Stadt;23843;52,6;25005;12180;12825;475
504;Ingelheim am Rhein, Stadt;55218;49,86;24998;12337;12661;501
505;Schmallenberg, Stadt;57392;303,1;24997;12689;12308;82
506;Saalfeld/Saale, Stadt;7318;48,73;24911;11992;12919;511
507;Harsewinkel, Die Mähdrescherstadt;33428;100,59;24862;12584;12278;247
508;Delitzsch, Stadt;4509;85,92;24815;12140;12675;289
509;Weingarten, Stadt;88250;12,16;24808;11890;12918;2040
510;Schleswig, Stadt;24837;24,3;24773;12071;12702;1019
511;Senftenberg, Stadt;1968;127,56;24773;12063;12710;194
512;Espelkamp, Stadt;32339;84,21;24766;12092;12674;294
513;Ditzingen, Stadt;71254;30,38;24698;12265;12433;813
514;Groß-Gerau, Stadt;64521;54,48;24695;12283;12412;453
515;Horb am Neckar, Stadt;72160;119,76;24687;12481;12206;206
516;Pfungstadt, Stadt;64319;42,53;24645;12140;12505;579
517;Ellwangen (Jagst), Stadt;73479;127,38;24643;12466;12177;193
518;Obertshausen, Stadt;63179;13,62;24573;11976;12597;1804
519;Idstein, Hochschulstadt;65510;79,69;24558;11842;12716;308
520;Lüdinghausen, Stadt;59348;140,54;24556;12215;12341;175
521;Meckenheim, Stadt;53340;34,84;24553;11989;12564;705
522;Olpe, Stadt;57462;85,88;24511;11931;12580;285
523;Geretsried, St;82538;24,6;24483;12056;12427;995
524;Markkleeberg, Stadt;4416;31,44;24477;11693;12784;779
525;Quedlinburg, Welterbestadt;6484;120,44;24411;11618;12793;203
526;Arnstadt, Stadt;99310;55,08;24340;11859;12481;442
527;Syke, Stadt;28857;128,11;24298;12018;12280;190
528;Attendorn, Hansestadt;57439;97,95;24279;12161;12118;248
529;Rathenow, Stadt;14712;113,1;24243;11772;12471;214
530;Salzwedel, Hansestadt;29410;304,58;24199;12028;12171;79
531;Stutensee, Stadt;76297;45,68;24199;11980;12219;530
532;Übach-Palenberg, Stadt;52531;26,12;24198;12167;12031;926
533;Limbach-Oberfrohna, Stadt;9212;50,21;24113;11701;12412;480
534;Ronnenberg, Stadt;30952;37,89;24050;11936;12114;635
535;Eisleben, Lutherstadt;6295;143,87;23940;11692;12248;166
536;Varel, Stadt;26316;113,75;23936;11646;12290;210
537;Waldshut-Tiengen, Stadt;79761;77,97;23873;11738;12135;306
538;Döbeln, Stadt;4720;91,74;23823;11698;12125;260
539;Sonneberg, Stadt;96515;84,69;23804;11551;12253;281
540;Hann. Münden, Stadt;34346;121,16;23797;11721;12076;196
541;Öhringen, Stadt;74613;67,79;23771;11862;11909;351
542;Haren (Ems), Stadt;49733;208,79;23747;11988;11759;114
543;Sehnde, Stadt;31319;103,58;23584;11891;11693;228
544;Korbach, Hansestadt, Kreisstadt;34497;123,98;23583;11483;12100;190
545;Bedburg, Stadt;50181;80,42;23577;11906;11671;293
546;Dillenburg, Stadt;35683;83,89;23542;11614;11928;281
547;Warburg, Hansestadt;34414;168,84;23365;11591;11774;138
548;Netphen, Stadt;57250;137,39;23356;11682;11674;170
549;Riedstadt, Stadt;64560;73,73;23340;11618;11722;317
550;Helmstedt, Stadt;38350;47,14;23336;11347;11989;495
551;Bad Mergentheim, Stadt;97980;129,96;23227;11265;11962;179
552;Starnberg, St;82319;61,85;23207;10904;12303;375
553;Calw, Stadt;75365;59,88;23158;11726;11432;387
554;Walsrode, Stadt;29664;272,29;23139;11433;11706;85
555;Mosbach, Stadt;74821;62,17;23101;11457;11644;372
556;Husum, Stadt;25813;25,81;23097;11075;12022;895
557;Herzogenaurach, St;91074;47,62;23081;11594;11487;485
558;Wertheim, Stadt;97877;138,59;23052;11488;11564;166
559;Waldkraiburg, St;84478;21,56;23042;11484;11558;1069
560;Glauchau, Stadt;8371;51,62;22925;11276;11649;444
561;Burg, Stadt;39288;164,05;22834;11552;11282;139
562;Gardelegen, Hansestadt;39638;632,43;22826;11411;11415;36
563;Gelnhausen, Barbarossast., Krst.;63571;45,19;22796;11224;11572;504
564;Freudenstadt, Stadt;72250;87,54;22796;11059;11737;260
565;Herdecke, Stadt;58313;22,39;22768;10841;11927;1017
566;Spremberg, Stadt;3130;202,32;22750;11065;11685;112
567;Rudolstadt, Stadt;7407;55,41;22704;11019;11685;410
568;Vreden, Stadt;48691;135,83;22611;11533;11078;166
569;Überlingen, Stadt;88662;58,66;22573;10517;12056;385
570;Lengerich, Stadt;49525;90,79;22530;11145;11385;248
571;Leutkirch im Allgäu, Stadt;88299;174,98;22515;11298;11217;129
572;Radevormwald, Stadt auf der Höhe;42477;53,86;22473;10961;11512;417
573;Westerstede, Stadt;26655;179,55;22399;10972;11427;125
574;Bad Soden am Taunus, Stadt;65812;12,55;22393;10695;11698;1785
575;Donaueschingen, Stadt;78166;104,67;22356;11322;11034;214
576;Weilheim i.OB, St;82362;55,5;22345;10746;11599;403
577;Apolda, Stadt;99510;46,27;22279;10966;11313;482
578;Karben, Stadt;61184;43,94;22211;11079;11132;505
579;Stadthagen, Stadt;31655;60,27;22148;10705;11443;367
580;Senden, St;89250;25,21;22128;10818;11310;878
581;Gersthofen, St;86368;34,01;22120;10984;11136;650
582;Friesoythe, Stadt;26169;247,49;22082;11134;10948;89
583;Osterode am Harz, Stadt;37520;102,54;21985;10900;11085;214
584;Sondershausen, Stadt;99706;201,21;21974;10787;11187;109
585;Bad Harzburg, Stadt;38667;65,52;21969;10260;11709;335
586;Nagold, Stadt;72202;63,09;21949;10921;11028;348
587;Eckernförde, Stadt;24340;21,38;21942;10429;11513;1026
588;Büdingen, Stadt;63654;122,88;21902;11010;10892;178
589;Bad Kissingen, GKSt;97688;69,92;21879;10078;11801;313
590;Zerbst/Anhalt, Stadt;39261;467,77;21876;10753;11123;47
591;Neusäß, St;86356;25,22;21861;10493;11368;867
592;Waldkirch, Stadt;79183;48,47;21786;10581;11205;449
593;Laupheim, Stadt;88471;61,79;21742;10861;10881;352
594;Metzingen, Stadt;72555;34,55;21721;10661;11060;629
595;Halle (Westf.), Stadt;33790;69,7;21692;10764;10928;311
596;Büren, Stadt;33142;170,99;21657;11174;10483;127
597;Hockenheim, Stadt;68766;34,84;21625;10845;10780;621
598;Schwetzingen, Stadt;68723;21,62;21580;10453;11127;998
599;Xanten, Stadt;46509;72,43;21551;10604;10947;298
600;Rotenburg (Wümme), Stadt;27356;99,06;21548;10573;10975;218
601;Versmold, Stadt;33775;85,57;21543;10868;10675;252
602;Heide, Stadt;25746;31,97;21529;10208;11321;673
603;Sonthofen, St;87527;46,55;21529;10304;11225;463
604;Eppingen, Stadt;75031;88,58;21446;10681;10765;242
605;Stadtallendorf, Stadt;35260;78,29;21388;10640;10748;273
606;Wipperfürth, Hansestadt;51688;118,3;21372;10561;10811;181
607;Waren (Müritz), Stadt;17192;159,46;21367;10061;11306;134
608;Soltau, Stadt;29614;203,77;21324;10449;10875;105
609;Puchheim, St;82178;12,24;21300;10315;10985;1741
610;Wülfrath, Stadt;42489;32,27;21273;10384;10889;659
611;Elsdorf, Stadt;50189;66,17;21264;10450;10814;321
612;Eschborn, Stadt;65760;12,13;21228;10407;10821;1749
613;Meiningen, Stadt;98617;59,46;21223;10452;10771;357
614;Seligenstadt, Stadt;63500;30,85;21184;10297;10887;687
615;Rees, Stadt;46459;109,86;21140;10404;10736;192
616;Aichach, St;86551;92,84;21130;10306;10824;228
617;Geseke, Stadt;59590;97,88;21129;10499;10630;216
618;Flörsheim am Main, Stadt;65439;22,95;21121;10320;10801;920
619;Reichenbach im Vogtland, Stadt;8468;34,46;21112;10174;10938;613
620;Groß-Umstadt, Stadt;64823;86,84;21058;10451;10607;242
621;Schramberg, Stadt;78713;80,7;21048;10537;10511;261
622;Bad Rappenau, Stadt;74906;73,56;20946;10324;10622;285
623;Greiz, Stadt;7973;76,44;20920;10130;10790;274
624;Fröndenberg/Ruhr, Stadt;58730;56,23;20908;10285;10623;372
625;Werdau, Stadt;8412;65,63;20905;10238;10667;319
626;Traunreut, St;83301;45,06;20899;10329;10570;464
627;Kitzingen, GKSt;97318;46,99;20892;10170;10722;445
628;Blieskastel, Stadt;66440;108,21;20886;10362;10524;193
629;Kaltenkirchen, Stadt;24568;23,1;20852;10219;10633;903
630;Coswig, Stadt;1640;25,88;20841;9994;10847;805
631;Waghäusel, Stadt;68753;42,84;20811;10336;10475;486
632;Quickborn, Stadt;25451;43,17;20808;10106;10702;482
633;Germersheim, Stadt;76726;21,68;20777;10461;10316;958
634;Duderstadt, Stadt;37115;95,64;20677;10149;10528;216
635;Meinerzhagen, Stadt;58540;115,67;20650;10332;10318;179
636;Herborn, Stadt;35745;63,8;20618;10124;10494;323
637;Burgwedel, Stadt;30938;152,85;20594;9815;10779;135
638;Luckenwalde, Stadt;14943;46,61;20521;9962;10559;440
639;Enger, Widukindstadt;32130;41,24;20483;10074;10409;497
640;Bruchköbel, Stadt;63486;29,69;20475;10018;10457;690
641;Wittmund, Stadt;26409;210,15;20437;10062;10375;97
642;Neustrelitz, Stadt;17235;139,86;20426;9893;10533;146
643;Schortens, Stadt;26419;68,8;20416;9980;10436;297
644;Eislingen/Fils, Stadt;73054;16,41;20390;10025;10365;1243
645;Stadtlohn, Stadt;48703;79,25;20389;10263;10126;257
646;Dillingen/ Saar, Stadt;66763;22,05;20385;9942;10443;924
647;Rheinstetten, Stadt;76287;32,31;20365;9942;10423;630
648;Annaberg-Buchholz, Stadt;9456;28,15;20292;9747;10545;721
649;Günzburg, GKSt;89312;55,4;20289;9987;10302;366
650;Mössingen, Stadt;72116;50,03;20286;9847;10439;406
651;Blankenburg (Harz), Stadt;38889;148,94;20189;9740;10449;136
652;Holzminden, Stadt;37603;88,24;20189;9965;10224;229
653;Bad Schwartau, Stadt;23611;18,39;20096;9364;10732;1093
654;Bad Waldsee, Stadt;88339;108,55;20090;9795;10295;185
655;Lichtenfels, St;96215;122,16;20064;9874;10190;164
656;Torgau, Stadt;4860;102,8;20062;9941;10121;195
657;Nidderau, Stadt;61130;46,73;20051;9975;10076;429
658;Hörstel, Stadt;48477;107,54;20038;10068;9970;186
659;Nördlingen, GKSt;86720;68,09;20005;9887;10118;294
660;Zülpich, Stadt;53909;101,01;19998;9820;10178;198
661;Schifferstadt, Stadt;67105;28,06;19983;9927;10056;712
662;Traunstein, GKSt;83278;48,57;19983;9575;10408;411
663;Ennigerloh, Stadt;59320;125,56;19973;10012;9961;159
664;Oberkirch, Stadt;77704;69,09;19955;9923;10032;289
665;Oschersleben (Bode), Stadt;39387;188,92;19953;9785;10168;106
666;Marsberg, Stadt;34431;182,22;19826;10120;9706;109
667;Donauwörth, GKSt;86609;77,04;19749;9901;9848;256
668;Eschwege, Kreisstadt;37269;63,27;19716;9542;10174;312
669;Telgte, Stadt;48291;90,84;19697;9506;10191;217
670;Gerlingen, Stadt;70839;17,01;19689;9620;10069;1158
671;Mühldorf a.Inn, St;84453;29,42;19660;9750;9910;668
672;Schopfheim, Stadt;79650;67,94;19645;9513;10132;289
673;Ochtrup, Stadt;48607;105,63;19634;9979;9655;186
674;Giengen an der Brenz, Stadt;89537;44,07;19568;9784;9784;444
675;Wildeshausen, Stadt;27793;89,7;19560;9680;9880;218
676;Sulzbach-Rosenberg, St;92237;53,12;19456;9586;9870;366
677;Bückeburg, Stadt;31675;68,9;19381;9340;10041;281
678;Borna, Stadt;4552;62,44;19319;9322;9997;309
679;Haiger, Stadt;35708;106,67;19316;9554;9762;181
680;Seesen, Stadt;38723;102,32;19314;9363;9951;189
681;Dingolfing, St;84130;44;19311;10040;9271;439
682;Waldbröl, Stadt;51545;63,32;19283;9406;9877;305
683;Prenzlau, Stadt;17291;142,96;19279;9285;9994;135
684;Bad Berleburg, Stadt;57319;275,52;19261;9675;9586;70
685;Sarstedt, Stadt;31157;43;19261;9477;9784;448
686;Haldensleben, Stadt;39340;156,2;19246;9584;9662;123
687;Rhede, Stadt;46414;78,9;19215;9551;9664;244
688;Korntal-Münchingen, Stadt;70825;20,71;19195;9546;9649;927
689;Schenefeld, Stadt;22869;9,99;19168;9345;9823;1919
690;Bad Pyrmont, Stadt;31812;61,99;19154;9042;10112;309
691;Schmalkalden, Kurort, Stadt;98574;98,3;19149;9729;9420;195
692;Bad Krozingen, Stadt;79189;35,65;19136;9204;9932;537
693;Bad Friedrichshall, Stadt;74177;24,71;19087;9639;9448;773
694;Alfeld (Leine), Stadt;31061;72,88;19061;9367;9694;262
695;Hechingen, Stadt;72379;66,41;19047;9442;9605;287
696;Mayen, Stadt;56727;58,19;19000;9429;9571;327
697;Weil der Stadt, Stadt;71263;43,17;18983;9480;9503;440
698;Crimmitschau, Stadt;8451;61,15;18982;9157;9825;310
699;Mölln, Stadt;23879;25,05;18970;9069;9901;757
700;Bergneustadt, Stadt;51702;37,89;18947;9270;9677;500
701;Heusenstamm, Stadt;63150;19,03;18932;9361;9571;995
702;Tettnang, Stadt;88069;71,25;18889;9407;9482;265
703;Müllheim, Stadt;79379;57,91;18887;9147;9740;326
704;Sömmerda, Stadt;99610;81,11;18884;9270;9614;233
705;Hemmingen, Stadt;30966;31,73;18872;9198;9674;595
706;Lebach, Stadt;66822;64,21;18864;9576;9288;294
707;Auerbach/Vogtl., Stadt;8209;55,52;18779;9043;9736;338
708;Wittlich, Stadt;54516;49,63;18748;9442;9306;378
709;Püttlingen, Stadt;66346;23,95;18700;9044;9656;781
710;Vlotho, Stadt;32602;76,93;18663;9287;9376;243
711;Forst (Lausitz), Stadt;3149;110,7;18651;9076;9575;168
712;Schneverdingen, Stadt;29640;234,92;18624;9053;9571;79
713;Leinefelde-Worbis, Stadt;37327;96,87;18622;9281;9341;192
714;Bremervörde, Stadt;27432;150,42;18608;9380;9228;124
715;Bad Dürkheim, Stadt;67098;102,55;18601;8779;9822;181
716;Bad Aibling, St;83043;41,4;18595;8958;9637;449
717;Dillingen a.d.Donau, GKSt;89407;75,59;18538;9129;9409;245
718;Bad Tölz, St;83646;30,8;18527;8845;9682;602
719;Wolfratshausen, St;82515;9,13;18491;8960;9531;2025
720;Radeberg, Stadt;1454;29,83;18491;9109;9382;620
721;Alzenau, St;63755;59,3;18467;9044;9423;311
722;Burghausen, St;84489;19,81;18431;8977;9454;930
723;Marktoberdorf, St;87616;95,15;18390;9112;9278;193
724;Sachsenheim, Stadt;74343;57,92;18386;9123;9263;317
725;Kolbermoor, St;83059;19,83;18371;8991;9380;927
726;Bad Driburg, Stadt4);33014;115,3;/;/;/;/
727;Glinde, Stadt;21509;11,22;18335;8996;9339;1634
728;Burscheid, Stadt;51399;27,33;18288;9050;9238;669
729;Kronberg im Taunus, Stadt;61476;18,62;18275;8585;9690;981
730;Uetersen, Stadt;25436;11,43;18272;8964;9308;1599
731;Großenhain, Stadt;1558;130,36;18268;8996;9272;140
732;Weißenburg i.Bay., GKSt;91781;97,58;18256;8955;9301;187
733;Pfullingen, Stadt;72793;30,14;18251;8867;9384;605
734;Konz, Stadt;54329;44,56;18206;8906;9300;409
735;Moosburg a.d.Isar, St;85368;43,85;18181;9124;9057;415
736;Hessisch Oldendorf, Stadt;31840;120,32;18170;8964;9206;151
737;Zossen, Stadt;15806;180,4;18115;9031;9084;100
738;Alzey, Stadt;55232;35,22;18114;8973;9141;514
739;Pohlheim, Stadt;35415;38;18094;8860;9234;476
740;Schwalmstadt, Stadt;34613;84,74;18087;9176;8911;213
741;Lahnstein, Stadt;56112;37,62;18068;8715;9353;480
742;Vellmar, Stadt;34246;13,97;18067;8528;9539;1293
743;Wassenberg, Stadt;41849;42,43;18019;8892;9127;425
744;Parchim, Stadt;19370;124,82;17964;8719;9245;144
745;Buchen (Odenwald), Stadt;74722;138,93;17922;8867;9055;129
746;Schkeuditz, Stadt;4435;81,47;17900;9220;8680;220
747;Werdohl, Stadt;58791;33,39;17892;8869;9023;536
748;Bexbach, Stadt;66450;31,09;17782;8715;9067;572
749;Frankenberg (Eder), Stadt;35066;124,87;17773;8825;8948;142
750;Wörth am Rhein, Stadt;76744;131,62;17762;8731;9031;135
751;Bad Reichenhall, GKSt;83435;41,92;17752;8450;9302;423
752;Freudenberg, Stadt;57258;54,6;17734;8854;8880;325
753;Thale, Stadt;6502;137,58;17708;8750;8958;129
754;Oberasbach, St;90522;12,08;17553;8423;9130;1452
755;Renningen, Stadt;71272;31,15;17510;8779;8731;562
756;Sinzig, Stadt;53489;41,1;17503;8539;8964;426
757;Sigmaringen, Stadt;72488;92,84;17494;9000;8494;188
758;Guben, Stadt;3172;43,99;17471;8359;9112;397
759;Nauen, Stadt;14641;268,14;17436;8651;8785;65
760;Bad Segeberg, Stadt;23795;18,87;17427;8365;9062;924
761;Bad Saulgau, Stadt;88348;97,33;17426;8497;8929;179
762;Bad Langensalza, Stadt;99947;123,67;17397;8516;8881;141
763;Bad Münder am Deister, Stadt;31848;107,97;17384;8489;8895;161
764;Hochheim am Main, Stadt;65239;19,43;17358;8450;8908;893
765;Wittenberge, Stadt;19322;50,63;17318;8374;8944;342
766;Nidda, Stadt;63667;118,35;17293;8675;8618;146
767;Bad Münstereifel, Stadt;53902;150,83;17291;8441;8850;115
768;Marktredwitz, GKSt;95615;49,52;17262;8281;8981;349
769;Oerlinghausen, Stadt;33813;32,69;17259;8447;8812;528
770;Marienberg, Stadt;9496;133,5;17254;8553;8701;129
771;Horn-Bad Meinberg, Stadt;32805;90,15;17253;8387;8866;191
772;Altena, Stadt;58762;44,42;17218;8507;8711;388
773;Schwarzenberg/Erzgeb., Stadt;8340;46,31;17191;8206;8985;371
774;Gescher, Glockenstadt;48712;80,84;17175;8661;8514;212
775;Bobingen, St;86399;50,25;17130;8483;8647;341
776;Illertissen, St;89257;36,39;17130;8409;8721;471
777;Garching b.München, St;85748;28,17;17099;8829;8270;607
778;Bad Säckingen, Stadt;79713;25,34;17073;8273;8800;674
779;Eutin, Stadt;23701;41,4;17041;8035;9006;412
780;Eltville am Rhein, Stadt;65343;46,77;16999;8233;8766;363
781;Bad Wildungen, Stadt;34537;120,08;16980;8325;8655;141
782;Heilbad Heiligenstadt, Stadt;37308;62,26;16962;8465;8497;272
783;Damme, Stadt;49401;104,39;16940;8496;8444;162
784;Schrobenhausen, St;86529;75,26;16936;8364;8572;225
785;Kronach, St;96317;66,98;16917;8228;8689;253
786;Stockach, Stadt;78333;69,73;16813;8328;8485;241
787;Bendorf, Stadt;56170;24,12;16809;8225;8584;697
788;Babenhausen, Stadt;64832;66,87;16729;8425;8304;250
789;Cham, St;93413;80,69;16701;8264;8437;207
790;Weißwasser/O.L., Stadt;2943;63,42;16660;7962;8698;263
791;Freilassing, St;83395;14,81;16648;8060;8588;1124
792;Diepholz, Stadt;49356;104,68;16521;8156;8365;158
793;Gunzenhausen, St;91710;82,72;16513;7893;8620;200
794;Finsterwalde, Stadt;3238;77,21;16497;7893;8604;214
795;Penzberg, St;82377;25,73;16479;8075;8404;640
796;Königstein im Taunus, Stadt;61462;25,07;16474;7770;8704;657
797;Kelheim, St;93309;76,7;16472;8274;8198;215
798;Remagen, Stadt;53424;33,21;16469;8094;8375;496
799;Brakel, Stadt;33034;173,92;16449;8293;8156;95
800;Sulzbach/ Saar, Stadt;66280;16,07;16419;8040;8379;1022
801;Kirchhain, Stadt;35274;90,92;16412;8125;8287;181
802;Heidenau, Stadt;1809;11,07;16399;8078;8321;1482
803;Trossingen, Stadt;78647;24,2;16394;8222;8172;677
804;Ginsheim-Gustavsburg, Stadt;65462;13,94;16347;8003;8344;1173
805;Hünfeld, Konrad-Zuse-Stadt;36088;119,77;16327;8221;8106;136
806;Wurzen, Stadt;4808;69,04;16293;7802;8491;236
807;Wendlingen am Neckar, Stadt;73240;12,15;16282;8084;8198;1340
808;Kierspe, Stadt;58566;71,91;16272;8049;8223;226
809;Schwarzenbek, Stadt;21493;11,56;16261;8000;8261;1407
810;Halver, Stadt;58553;77,23;16259;7967;8292;211
811;Reinheim, Stadt;64354;27,7;16254;8004;8250;587
812;Vilshofen an der Donau, St;94474;86,29;16250;8072;8178;188
813;Aue, Stadt;8280;20,92;16235;7757;8478;776
814;Bürstadt, Stadt;68642;34,46;16176;8044;8132;469
815;Bargteheide, Stadt;22941;15,82;16135;7738;8397;1020
816;Templin, Stadt;17268;379,49;16117;7849;8268;42
817;Zeulenroda-Triebes, Stadt;7937;135,14;16115;7812;8303;119
818;Lübbenau/Spreewald, Stadt;3222;139,4;16109;7823;8286;116
819;Michelstadt, Stadt;64720;86,98;16055;7928;8127;185
820;Preetz, Stadt;24211;14,4;16032;7637;8395;1113
821;Erwitte, Stadt;59597;89,41;16018;7907;8111;179
822;Kelsterbach, Stadt;65451;15,37;16001;8230;7771;1041
823;Raunheim, Stadt;65479;12,61;16000;8030;7970;1269
824;Alsfeld, Stadt;36304;129,69;15982;7880;8102;123
825;Freiberg am Neckar, Stadt;71691;13,14;15959;7838;8121;1215
826;Brackenheim, Stadt;74336;45,75;15912;7974;7938;348
827;Schlüchtern, Stadt;36381;113,31;15911;7848;8063;140
828;Straelen, Stadt;47638;74,04;15901;7943;7958;215
829;Königslutter am Elm, Stadt;38154;131,12;15880;7829;8051;121
830;Blaustein, Stadt;89134;55,61;15873;7940;7933;285
831;Wadern, Stadt;66687;111,14;15808;7832;7976;142
832;Bassum, Stadt;27211;168,85;15737;7808;7929;93
833;Bad Wörishofen, St;86825;57,79;15731;7445;8286;272
834;Bad Salzungen, Stadt;36433;39,04;15696;7692;8004;402
835;Bad Lippspringe, Stadt;33175;51,01;15695;7633;8062;308
836;Marbach am Neckar, Stadt;71672;18,06;15682;7676;8006;868
837;Dieburg, Stadt;64807;23,08;15592;7618;7974;676
838;Eilenburg, Stadt;4838;46,84;15578;7520;8058;333
839;Weener, Stadt;26826;81,23;15541;7755;7786;191
840;Clausthal-Zellerfeld, Berg- und Universitätsstadt;38678;43,69;15523;8681;6842;355
841;Bad Arolsen, Stadt;34454;126,38;15501;7633;7868;123
842;Markranstädt, Stadt;4420;58,46;15489;7520;7969;265
843;Pocking, St;94060;68,86;15482;7526;7956;225
844;Drensteinfurt, Stadt;48317;106,6;15471;7679;7792;145
845;Walldorf, Stadt;69190;19,91;15460;7739;7721;777
846;Schwalbach am Taunus, Stadt;65824;6,47;15452;7432;8020;2388
847;Rahden, Stadt;32369;137,48;15451;7779;7672;112
848;Füssen, St;87629;43,48;15425;7406;8019;355
849;Boppard, Stadt;56154;74,88;15409;7542;7867;206
850;Breisach am Rhein, Stadt;79206;54,59;15388;7624;7764;282
851;Ebersbach an der Fils, Stadt;73061;26,26;15363;7641;7722;585
852;Taucha, Stadt;4425;33,23;15356;7450;7906;462
853;Bad Bentheim, Stadt;48455;99,99;15353;7623;7730;154
854;Bad Neustadt a.d.Saale, St;97616;36,89;15334;7390;7944;416
855;Blomberg, Stadt;32825;99,1;15274;7634;7640;154
856;Altdorf b.Nürnberg, St;90518;48,59;15274;7526;7748;314
857;Hofgeismar, Stadt;34369;86,39;15247;7373;7874;176
858;Künzelsau, Stadt;74653;75,17;15246;7692;7554;203
859;Eppelheim, Stadt;69214;5,7;15241;7494;7747;2675
860;Hückeswagen, Schloss-Stadt;42499;50,52;15214;7560;7654;301
861;Neustadt in Holstein, Stadt;23730;19,74;15211;7190;8021;771
862;Ribnitz-Damgarten, Stadt;18311;122,83;15208;7229;7979;124
863;Neustadt b.Coburg, GKSt;96465;61,89;15181;7411;7770;245
864;Ober-Ramstadt, Stadt;64372;41,88;15174;7464;7710;362
865;Kamenz, Stadt;1917;53,25;15153;7448;7705;285
866;Brake (Unterweser), Stadt;26919;38,3;15149;7385;7764;395
867;Lohr a.Main, St;97816;90,42;15145;7496;7649;167
868;Witzenhausen, Stadt;37213;126,69;15092;7350;7742;119
869;Hilchenbach, Stadt;57271;81,12;15039;7451;7588;185
870;Landsberg, Stadt;6188;125,38;15013;7512;7501;120
871;Löbau, Stadt;2708;78,9;15003;7274;7729;190
872;Selb, GKSt;95100;86,07;14999;7270;7729;174
873;Schriesheim, Stadt;69198;31,61;14983;7271;7712;474
874;Munster, Stadt;29633;194,52;14958;7706;7252;77
875;Mainburg, St;84048;61,53;14926;7573;7353;243
876;Mittweida, Stadt, Hochschulstadt;9648;41,26;14907;7410;7497;361
877;Langenau, Stadt;89129;75,03;14892;7476;7416;198
878;Karlstadt, St;97753;98,14;14885;7338;7547;152
879;Stadtbergen, St;86391;11,49;14848;7186;7662;1292
880;Gehrden, Stadt;30989;43,24;14845;7102;7743;343
881;Hohenstein-Ernstthal, Stadt;9337;18,58;14820;7097;7723;798
882;Lauchhammer, Stadt;1979;88,9;14791;7203;7588;166
883;Markgröningen, Stadt;71706;28,15;14752;7448;7304;524
884;Mindelheim, St;87719;56,42;14748;7339;7409;261
885;Olsberg, Stadt;59939;118;14747;7326;7421;125
886;Fritzlar, Dom- und Kaiserstadt;34560;88,78;14715;7255;7460;166
887;Kraichtal, Stadt;76703;80,59;14701;7315;7386;182
888;Neu-Anspach, Stadt;61267;36,14;14698;7252;7446;407
889;Spenge, Stadt;32139;40,35;14681;7173;7508;364
890;Eberbach, Stadt;69412;81,15;14670;7065;7605;181
891;Meerane, Stadt;8393;19,81;14659;7028;7631;740
892;Oschatz, Stadt;4758;55,44;14609;7145;7464;264
893;Lauda-Königshofen, Stadt;97922;94,44;14588;7260;7328;154
894;Ottweiler, Stadt;66564;45,56;14571;7252;7319;320
895;Bad Wurzach, Stadt;88410;182,24;14564;7433;7131;80
896;Bitburg, Stadt;54634;47,55;14540;6995;7545;306
897;Sandersdorf-Brehna, Stadt;6792;81,84;14530;7093;7437;178
898;Ratzeburg, Stadt;23909;30,29;14528;6862;7666;480
899;Dorfen, St;84405;99,56;14494;7269;7225;146
900;Dippoldiswalde, Stadt;1744;103,99;14478;7173;7305;139
901;Pattensen, Stadt;30982;67,13;14447;7041;7406;215
902;Hettstedt, Stadt;6333;36,93;14444;7086;7358;391
903;Genthin, Stadt;39307;230,73;14402;7152;7250;62
904;Sassenberg, Stadt;48336;78,08;14371;7238;7133;184
905;Rotenburg a. d. Fulda, Stadt;36199;79,83;14349;7157;7192;180
906;Uslar, Stadt;37170;113,58;14345;7059;7286;126
907;Uhingen, Stadt;73066;24,79;14312;7083;7229;577
908;Münsingen, Stadt;72525;116,93;14311;7063;7248;122
909;Wittstock/Dosse, Stadt;16909;420,24;14291;7043;7248;34
910;Frankenberg/Sa., Stadt;9669;65,62;14288;7092;7196;218
911;Jessen (Elster), Stadt;6917;352,12;14247;7094;7153;40
912;Usingen, Stadt;61250;55,83;14229;7007;7222;255
913;Immenstadt i.Allgäu, St;87509;81,43;14207;6921;7286;174
914;Gernsbach, Stadt;76593;82,03;14202;6984;7218;173
915;Jever, Stadt;26441;42,23;14201;6767;7434;336
916;Erlensee, Stadt;63526;18,59;14196;7034;7162;764
917;Schneeberg, Stadt;8289;23,35;14193;6907;7286;608
918;Wanzleben-Börde, Stadt;39164;188,07;14175;7107;7068;75
919;Bad Camberg, Stadt;65520;54,63;14148;6979;7169;259
920;Bad Bramstedt, Stadt;24576;24,14;14139;6965;7174;586
921;Lauterbach (Hessen), Kreisstadt;36341;102;14110;6988;7122;138
922;Plochingen, Stadt;73207;10,64;14086;6950;7136;1324
923;Wilsdruff, Stadt;1723;81,6;14004;6929;7075;172
924;Bebra, Stadt;36179;93,64;13963;6892;7071;149
925;Murrhardt, Stadt;71540;71,15;13953;6905;7048;196
926;Homberg (Efze), Reformationsstadt, Kreisstadt;34576;99,99;13950;6951;6999;140
927;Leuna, Stadt;6237;87,71;13911;6937;6974;159
928;Oberndorf am Neckar, Stadt;78727;55,92;13907;6936;6971;249
929;Langenselbold, Stadt;63505;26,26;13900;6787;7113;529
930;Oebisfelde-Weferlingen, Stadt;39646;249,31;13889;6998;6891;56
931;Kalkar, Stadt;47546;88,2;13880;6882;6998;157
932;Lübben (Spreewald), Stadt;15907;120,85;13861;6669;7192;115
933;Isny im Allgäu, Stadt;88316;85,39;13846;6872;6974;162
934;Schwabmünchen, St;86830;55,5;13837;6810;7027;249
935;Stein, St;90547;19,51;13828;6573;7255;709
936;Markdorf, Stadt;88677;40,91;13811;6794;7017;338
937;Bad Laasphe, Stadt;57334;135,95;13802;6940;6862;102
938;Angermünde, Stadt;16278;324,2;13797;6623;7174;43
939;Neustadt a.d.Donau, St;93333;93,53;13797;7055;6742;148
940;Zeven, Stadt;27404;74,14;13797;6982;6815;186
941;Grünberg, Stadt;35305;89,24;13717;6775;6942;154
942;Biedenkopf, Stadt;35216;90,33;13713;6827;6886;152
943;Eppstein, Stadt;65817;24,21;13702;6747;6955;566
944;Aßlar, Stadt;35614;43,57;13655;6753;6902;313
945;Melsungen, Stadt;34212;63,1;13647;6730;6917;216
946;Abensberg, St;93326;60,27;13646;7052;6594;226
947;Bergen auf Rügen, Stadt;18528;51,49;13618;6534;7084;264
948;Schwentinental, Stadt;24223;17,82;13608;6594;7014;764
949;Neutraubling, St;93073;9,75;13593;6686;6907;1394
950;Südliches Anhalt, Stadt;6369;191,54;13588;6752;6836;71
951;Eggenfelden, St;84307;44,35;13532;6639;6893;305
952;Erbach, Kreisstadt;64711;61,53;13513;6518;6995;220
953;Grafing b.München, St;85567;29,57;13502;6573;6929;457
954;Solms, Stadt;35606;34,05;13497;6700;6797;396
955;Lorsch, Karolingerstadt;64653;25,24;13492;6524;6968;535
956;Grünstadt, Stadt;67269;18,09;13468;6611;6857;744
957;Zehdenick, Stadt;16792;223,06;13463;6731;6732;60
958;Bad Soden-Salmünster, Stadt;63628;58,6;13463;6625;6838;230
959;Eichstätt, GKSt;85072;47,78;13457;6573;6884;282
960;Asperg, Stadt;71679;5,8;13437;6676;6761;2317
961;Weißenhorn, St;89264;53,72;13428;6767;6661;250
962;Haßfurt, St;97437;52,66;13385;6618;6767;254
963;Erbach, Stadt;89155;63,29;13376;6742;6634;211
964;Hilpoltstein, St;91161;89,71;13358;6802;6556;149
965;Philippsburg, Stadt;76661;50,54;13345;6850;6495;264
966;Tornesch, Stadt;25436;20,61;13319;6535;6784;646
967;Höchstadt a.d.Aisch, St;91315;70,87;13319;6632;6687;188
968;Beverungen, Stadt;37688;98,09;13313;6591;6722;136
969;Bergen, Stadt;29303;164,4;13313;6586;6727;81
970;Lich, Stadt;35423;77,63;13301;6537;6764;171
971;Vöhringen, St;89269;23,69;13298;6535;6763;561
972;Pegnitz, St;91257;99,98;13294;6489;6805;133
973;Bad Salzdetfurth, Stadt;31162;67,2;13281;6492;6789;198
974;Neckargemünd, Stadt;69151;26,16;13268;6469;6799;507
975;Tauberbischofsheim, Stadt;97941;69,29;13256;6579;6677;191
976;Löningen, Stadt;49624;143,53;13218;6606;6612;92
977;Wolfhagen, Stadt;34466;111,95;13199;6679;6520;118
978;Landau a.d.Isar, St;94405;84,39;13182;6523;6659;156
979;Sendenhorst, Stadt;48324;96,95;13182;6537;6645;136
980;Pfullendorf, Stadt;88630;90,5;13178;6567;6611;146
981;Herbrechtingen, Stadt;89542;58,63;13174;6513;6661;225
982;Burglengenfeld, St;93133;93,26;13129;6398;6731;141
983;Bad Dürrheim, Stadt;78073;62,08;13121;6340;6781;211
984;Wiesmoor, Stadt;26639;82,94;13116;6365;6751;158
985;Rödental, St;96472;49,97;13115;6487;6628;262
986;Waltershausen, Stadt;99880;60,62;13110;6506;6604;216
987;Östringen, Stadt;76684;53,28;13104;6732;6372;246
988;Quakenbrück, Stadt;49610;17,96;13090;6455;6635;729
989;Weilburg, Stadt;35781;57,5;13086;6540;6546;228
990;Herzberg am Harz, Stadt;37412;71,88;13051;6377;6674;182
991;Velen, Stadt;46342;70,75;13044;6648;6396;184
992;Montabaur, Stadt;56410;33,77;13042;6269;6773;386
993;Möckern, Stadt;39291;523,94;13030;6609;6421;25
994;Holzgerlingen, Stadt;71088;13,39;12984;6411;6573;970
995;Dinklage, Stadt;49413;72,81;12963;6559;6404;178
996;Plattling, St;94447;35,9;12960;6485;6475;361
997;Krumbach (Schwaben), St;86381;44,64;12953;6388;6565;290
998;Schleiden, Stadt;53937;121,67;12934;6387;6547;106
999;Ettenheim, Stadt;77955;48,8;12932;6251;6681;265
1000;Wehr, Stadt;79664;35,66;12924;6254;6670;362
1001;St. Georgen im Schwarzwald, Stadt;78112;59,84;12882;6381;6501;215
1002;Steinheim, Stadt;32839;75,69;12877;6395;6482;170
1003;Neustadt a.d.Aisch, St;91413;61,21;12875;6221;6654;210
1004;Winterberg, Stadt;59955;147,95;12844;6423;6421;87
1005;Treuchtlingen, St;91757;103,38;12833;6472;6361;124
1006;Altötting, St;84503;23,07;12808;6059;6749;555
1007;Brunsbüttel, Stadt;25541;65,2;12801;6433;6368;196
1008;Linden, Stadt;35440;22,77;12764;6382;6382;560
1009;Spaichingen, Stadt;78549;18,5;12762;6317;6445;690
1010;Wasserburg a.Inn, St;83512;18,8;12759;6402;6357;679
1011;Sulingen, Stadt;27232;110,83;12755;6335;6420;115
1012;Borken (Hessen), Stadt;34582;82,3;12741;6417;6324;155
1013;Haselünne, Stadt;49740;159,43;12728;6351;6377;80
1014;Schüttorf, Stadt;48465;19,45;12676;6372;6304;652
1015;Buchloe, St;86807;36,18;12667;6239;6428;350
1016;Anklam, Stadt;17389;56,68;12635;6006;6629;223
1017;Fehmarn, Stadt;23769;185,49;12552;6152;6400;68
1018;Wernau (Neckar), Stadt;73249;10,89;12532;6302;6230;1150
1019;Olfen, Stadt;59399;52,43;12470;6091;6379;238
1020;Wächtersbach, Stadt;63607;50,79;12447;6171;6276;245
1021;Hadamar, Stadt;65589;40,99;12444;6253;6191;304
1022;Preußisch Oldendorf, Stadt;32361;68,75;12432;6106;6326;181
1023;Linnich, Stadt;52441;65,43;12420;6142;6278;190
1024;Pfarrkirchen, St;84347;52,35;12410;6025;6385;237
1025;Hungen, Stadt;35410;86,78;12407;6120;6287;143
1026;Hersbruck, St;91217;22,91;12388;6110;6278;541
1027;Bad Windsheim, St;91438;78,24;12379;6051;6328;158
1028;Bad Urach, Stadt;72574;55,42;12373;6118;6255;223
1029;Perleberg, Stadt;19348;138,69;12367;6142;6225;89
1030;Neustadt i. Sa., Stadt;1844;83,12;12341;5963;6378;148
1031;Bad Freienwalde (Oder), Stadt;16259;131,11;12316;5995;6321;94
1032;Jüterbog, Stadt;14913;176,48;12308;6017;6291;70
1033;Ludwigslust, Stadt;19288;78,63;12306;5905;6401;157
1034;Feuchtwangen, St;91555;137,21;12287;6162;6125;90
1035;Ebersbach-Neugersdorf, Stadt;2730;20,45;12265;5948;6317;600
1036;Rosbach v. d. Höhe, Stadt;61191;45,33;12262;6100;6162;271
1037;Twistringen, Stadt;27239;114,37;12257;6193;6064;107
1038;Schongau, St;86956;21,34;12252;6127;6125;574
1039;Neuenburg am Rhein, Stadt;79395;44,1;12234;6072;6162;277
1040;Gladenbach, Stadt;35075;72,28;12225;6065;6160;169
1041;Besigheim, Stadt;74354;16,83;12215;6068;6147;726
1042;Bad Wünnenberg, Stadt;33181;161,3;12200;6071;6129;76
1043;Eisenberg, Stadt;7607;24,67;12199;6203;5996;494
1044;Gaildorf, Stadt;74405;62,59;12180;6004;6176;195
1045;Sulz am Neckar, Stadt;72172;87,62;12173;6040;6133;139
1046;Wolgast, Stadt;17438;61,75;12172;5968;6204;197
1047;Weinsberg, Stadt;74189;22,22;12168;6119;6049;548
1048;Beelitz, Stadt;14547;181,29;12166;6106;6060;67
1049;Burladingen, Stadt;72393;123,31;12164;5967;6197;99
1050;Steinheim an der Murr, Stadt;71711;23,18;12162;6015;6147;525
1051;Titisee-Neustadt, Stadt;79822;89,64;12151;6001;6150;136
1052;Zwönitz, Stadt;8297;64,24;12126;5885;6241;189
1053;Bad Doberan, Stadt;18209;32,85;12124;5814;6310;369
1054;Hessisch Lichtenau, Stadt;37235;105,87;12120;6077;6043;114
1055;Pößneck, Stadt;7381;24,43;12117;5847;6270;496
1056;Ebersberg, St;85560;40,84;12116;5969;6147;297
1057;Blaubeuren, Stadt;89143;79,13;12104;6095;6009;153
1058;Coswig (Anhalt), Stadt;6869;295,75;12095;6127;5968;41
1059;Hemsbach, Stadt;69502;12,85;12085;5960;6125;940
1060;Monschau, Stadt;52156;94,6;12065;6068;5997;128
1061;Pritzwalk, Stadt;16928;167,47;12050;5953;6097;72
1062;Neuenrade, Stadt;58809;54,1;12012;5981;6031;222
1063;Röthenbach a.d.Pegnitz, St;90552;14,29;11977;5754;6223;838
1064;Gräfenhainichen, Stadt;6773;158,94;11919;5812;6107;75
1065;Bad Dürrenberg, Stadt;6231;36,15;11844;5835;6009;328
1066;Drolshagen, Stadt;57489;67,11;11837;5963;5874;176
1067;Velten, Stadt;16727;23,36;11815;5799;6016;506
1068;Bopfingen, Stadt;73441;76,94;11772;5825;5947;153
1069;Oestrich-Winkel, Stadt;65375;59,53;11738;5740;5998;197
1070;Geisenheim, Hochschulstadt;65366;40,35;11730;5741;5989;291
1071;Hagenow, Stadt;19230;67,54;11713;5768;5945;173
1072;Vilsbiburg, St;84137;68,84;11711;5872;5839;170
1073;Roding, St;93426;113,7;11706;5832;5874;103
1074;Erkner, Stadt;15537;16,53;11695;5551;6144;708
1075;Langelsheim, Stadt;38685;48,81;11684;5817;5867;239
1076;Osterhofen, St;94486;111,17;11676;5825;5851;105
1077;Hildburghausen, Stadt;98646;72,9;11661;5765;5896;160
1078;Hauzenberg, St;94051;82,79;11603;5783;5820;140
1079;Dinkelsbühl, GKSt;91550;75,16;11600;5709;5891;154
1080;Billerbeck, Stadt;48727;91,37;11594;5805;5789;127
1081;Wittingen, Stadt;29378;225,83;11589;5848;5741;51
1082;Lichtenstein/Sa., Stadt;9350;15,47;11584;5557;6027;749
1083;Walldürn, Stadt;74731;105,91;11565;5880;5685;109
1084;Ladenburg, Stadt;68526;19;11555;5645;5910;608
1085;Balve, Stadt;58802;74,81;11517;5715;5802;154
1086;Lindenberg i.Allgäu, St;88161;11,84;11500;5648;5852;971
1087;Lauenburg/ Elbe, Stadt;21481;9,55;11498;5757;5741;1204
1088;Wolmirstedt, Stadt;39326;54,29;11475;5585;5890;211
1089;Miesbach, St;83714;32,44;11414;5541;5873;352
1090;Bad Fallingbostel, Stadt;29683;63,7;11413;5640;5773;179
1091;Schöningen, Stadt;38364;35,47;11405;5618;5787;321
1092;Ochsenfurt, St;97199;63,57;11393;5678;5715;179
1093;Werther (Westf.), Stadt;33824;35,42;11365;5688;5677;321
1094;Laichingen, Stadt;89150;69,83;11347;5776;5571;162
1095;Stollberg/Erzgeb., Stadt;9366;38,99;11333;5465;5868;291
1096;Rheinau, Stadt;77866;73,5;11250;5653;5597;153
1097;Trostberg, St;83308;51,55;11234;5504;5730;218
1098;Schwaigern, Stadt;74193;49,49;11229;5707;5522;227
1099;Osterwieck, Stadt;38835;212,87;11221;5669;5552;53
1100;Lauffen am Neckar, Stadt;74348;22,63;11201;5498;5703;495
1101;Glückstadt, Stadt;25348;22,75;11190;5448;5742;492
1102;Schmölln, Stadt;4626;41,61;11171;5492;5679;268
1103;Bischofswerda, Stadt;1877;46,21;11169;5341;5828;242
1104;Mülheim-Kärlich, Stadt;56218;16,42;11157;5495;5662;679
1105;Oelsnitz/Erzgeb., Stadt;9376;26,28;11141;5400;5741;424
1106;Geisenfeld, St;85290;88,3;11130;5886;5244;126
1107;Marktheidenfeld, St;97828;35,7;11126;5380;5746;312
1108;Maxhütte-Haidhof, St;93142;34,69;11120;5588;5532;321
1109;Bad Belzig, Stadt;14806;236,06;11113;5474;5639;47
1110;Hammelburg, St;97762;128,88;11093;5488;5605;86
1111;Rothenburg ob der Tauber, GKSt;91541;41,67;11085;5389;5696;266
1112;Braunsbedra, Stadt;6242;74,3;11085;5644;5441;149
1113;Demmin, Hansestadt;17109;82,06;11052;5281;5771;135
1114;Welzheim, Stadt;73642;37,99;11043;5408;5635;291
1115;Diez, Stadt;65582;12,41;11011;5695;5316;887
1116;Rüthen, Stadt;59602;158,15;10955;5691;5264;69
1117;Braunfels, Stadt;35619;47,29;10954;5334;5620;232
1118;Gengenbach, Stadt;77723;61,9;10940;5255;5685;177
1119;Querfurt, Stadt;6268;155,42;10915;5319;5596;70
1120;Flöha, Stadt;9557;27,76;10894;5242;5652;392
1121;Donzdorf, Stadt;73072;39,82;10894;5469;5425;274
1122;Tangerhütte, Stadt;39517;294,83;10884;5413;5471;37
1123;Regen, St;94209;65,14;10884;5423;5461;167
1124;Lauingen (Donau), St;89415;44,39;10869;5367;5502;245
1125;Gronau (Leine), Stadt;31028;88,39;10849;5294;5555;123
1126;Bad Schwalbach, Kreisstadt;65307;40,27;10849;5410;5439;269
1127;Bad Nenndorf, Stadt;31542;23,22;10840;5130;5710;467
1128;Lorch, Stadt;73547;34,28;10796;5442;5354;315
1129;Meßstetten, Stadt;72469;76,8;10792;5602;5190;141
1130;Herbolzheim, Stadt;79336;35,48;10787;5415;5372;304
1131;Nossen, Stadt;1683;122,74;10771;5395;5376;88
1132;Burgstädt, Stadt;9217;25,87;10764;5249;5515;416
1133;Oberharz am Brocken, Stadt;38875;271,52;10731;5229;5502;40
1134;Rutesheim, Stadt;71277;16,22;10717;5305;5412;661
1135;Engen, Stadt;78234;70,56;10644;5256;5388;151
1136;Isselburg, Stadt;46419;42,8;10634;5360;5274;248
1137;Lichtenau, Stadt;33165;192,57;10632;5487;5145;55
1138;Bad Iburg, Stadt;49186;36,5;10630;5133;5497;291
1139;Felsberg, Stadt;34587;83,28;10611;5230;5381;127
1140;Zella-Mehlis, Stadt;98544;28,07;10595;5169;5426;378
1141;Bad Lauterberg im Harz, Stadt;37431;41,56;10548;5058;5490;254
1142;Haigerloch, Stadt;72401;76,44;10547;5263;5284;138
1143;Gommern, Stadt;39245;159,98;10543;5138;5405;66
1144;Steinbach (Taunus), Stadt;61449;4,4;10536;5090;5446;2392
1145;Boizenburg/ Elbe, Stadt;19258;47,43;10527;5218;5309;222
1146;Langenzenn, St;90579;46,33;10511;5079;5432;227
1147;Tangermünde, Stadt;39590;89,87;10471;5056;5415;117
1148;Riedlingen, Stadt;88499;64,95;10463;5232;5231;161
1149;Grevesmühlen, Stadt;23936;52,38;10440;5092;5348;199
1150;Oelsnitz/Vogtl., Stadt;8606;53,67;10435;5095;5340;194
1151;Altensteig, Stadt;72213;53,19;10406;5220;5186;196
1152;Pasewalk, Stadt;17309;55,21;10403;4917;5486;188
1153;Waldkirchen, St;94065;80,01;10384;5123;5261;130
1154;Steinau an der Straße, Brüder-Grimm-Stadt;36396;104,87;10335;5124;5211;99
1155;Bad Staffelstein, St;96231;99,51;10322;5081;5241;104
1156;Barmstedt, Stadt;25355;17,17;10283;5034;5249;599
1157;Münchberg, St;95213;68,78;10242;4915;5327;149
1158;Weilheim an der Teck, Stadt;73235;26,51;10237;5142;5095;386
1159;Meuselwitz, Stadt;4610;53,66;10230;4943;5287;191
1160;Büdelsdorf, Stadt;24782;6,48;10230;4942;5288;1579
1161;Lollar, Stadt;35457;21,41;10226;5080;5146;478
1162;Rehburg-Loccum, Stadt;31547;99,97;10219;5167;5052;102
1163;Friedrichsthal, Stadt;66299;8,99;10213;4996;5217;1136
1164;Gemünden a.Main, St;97737;75,06;10204;5068;5136;136
1165;Klötze, Stadt;38486;278,29;10201;5019;5182;37
1166;Gernsheim, Schöfferstadt;64579;40,11;10178;5030;5148;254
1167;Erlenbach a.Main, St;63906;16,31;10138;5034;5104;621
1168;Aulendorf, Stadt;88326;52,34;10137;5090;5047;194
1169;Aichtal, Stadt;72631;23,6;10129;5180;4949;429
1170;Süßen, Stadt;73079;12,79;10100;5074;5026;790
1171;Frohburg, Stadt;4654;108,51;10085;4983;5102;93
1172;Betzdorf, Stadt;57518;9,56;10082;4941;5141;1055
1173;Schotten, Stadt;63679;133,56;10063;5176;4887;75
1174;Wildau, Stadt;15745;9,1;10057;4923;5134;1105
1175;Blumberg, Stadt;78176;98,72;9996;5042;4954;101
1176;Wilkau-Haßlau, Stadt;8112;12,65;9973;4729;5244;788
1177;Osterburg (Altmark), Hansestadt;39606;229,76;9973;4850;5123;43
1178;Kenzingen, Stadt;79341;36,93;9949;4987;4962;269
1179;Niebüll, Stadt;25899;30,63;9946;4804;5142;325
1180;Wildberg, Stadt;72218;56,68;9937;4987;4950;175
1181;Neuenhaus, Stadt;49828;31,37;9925;4974;4951;316
1182;Bogen, St;94327;49,74;9920;4969;4951;199
1183;Wettin-Löbejün, Stadt;6193;127,11;9903;4895;5008;78
1184;Kemberg, Stadt;6901;235,21;9899;4909;4990;42
1185;Rüdesheim am Rhein, Stadt;65385;51,44;9892;4960;4932;192
1186;Grimmen, Stadt;18507;50,51;9888;4700;5188;196
1187;Nideggen, Stadt;52385;65,04;9886;4835;5051;152
1188;Nieder-Olm, Stadt;55268;11,22;9885;4789;5096;881
1189;Oldenburg in Holstein, Stadt;23758;39,68;9864;4795;5069;249
1190;Dassel, Stadt;37586;113,24;9860;4892;4968;87
1191;Bad Gandersheim, Stadt;37581;90,85;9858;4769;5089;109
1192;Bad Wildbad, Stadt;75323;105,22;9849;4837;5012;94
1193;Sebnitz, Stadt;1855;88,23;9817;4854;4963;111
1194;Mengen, Stadt;88512;49,82;9783;4901;4882;196
1195;Heubach, Stadt;73540;25,78;9765;4821;4944;379
1196;Bad Orb, Stadt;63619;47,78;9759;4650;5109;204
1197;Bockenem, Stadt;31167;109,96;9741;4869;4872;89
1198;Simbach a.Inn, St;84359;47,33;9736;4753;4983;206
1199;Schlitz, Stadt;36110;142,09;9716;4835;4881;68
1200;Neuenstadt am Kocher, Stadt;74196;41,17;9713;4882;4831;236
1201;Visselhövede, Stadt;27374;159,2;9700;4748;4952;61
1202;Hohenmölsen, Stadt;6679;75,31;9696;4689;5007;129
1203;Laubach, Stadt;35321;97,02;9695;4741;4954;100
1204;Brand-Erbisdorf, Stadt;9618;46,33;9640;4688;4952;208
1205;Bad König, Stadt;64732;46,73;9639;4670;4969;206
1206;Gudensberg, Stadt;34281;46,5;9632;4753;4879;207
1207;Lügde, Stadt der Osterräder;32676;88,64;9624;4780;4844;109
1208;Brandis, Stadt;4821;34,89;9619;4740;4879;276
1209;Burgau, St;89331;25,92;9617;4805;4812;371
1210;Luckau, Stadt;15926;207,43;9574;4746;4828;46
1211;Beilngries, St;92339;100,02;9560;4954;4606;96
1212;Niesky, Stadt;2906;53,81;9543;4681;4862;177
1213;Dissen am Teutoburger Wald, Stadt;49201;31,9;9539;4798;4741;299
1214;Zwiesel, St;94227;41,16;9500;4659;4841;231
1215;Niddatal, Stadt;61194;40,26;9495;4733;4762;236
1216;Ilsenburg (Harz), Stadt;38871;62,97;9491;4696;4795;151
1217;Zschopau, Stadt;9405;22,79;9490;4591;4899;416
1218;Sassnitz, Stadt;18546;47,14;9485;4546;4939;201
1219;Runkel, Stadt;65594;43,72;9477;4717;4760;217
1220;Trebbin, Stadt;14959;126,37;9474;4804;4670;75
1221;Bleckede, Stadt;21354;140,65;9467;4606;4861;67
1222;Bad Ems, Stadt;56130;15,41;9457;4555;4902;614
1223;Endingen am Kaiserstuhl, Stadt;79346;26,7;9445;4693;4752;354
1224;Fürstenau, Stadt;49584;78,65;9437;4623;4814;120
1225;Neustadt (Hessen), Stadt;35279;56,88;9427;4833;4594;166
1226;Wahlstedt, Stadt;23812;15,75;9397;4595;4802;597
1227;Höhr-Grenzhausen, Stadt;56203;15,88;9388;4593;4795;591
1228;Zörbig, Stadt;6780;113,68;9372;4648;4724;82
1229;Rehau, St;95111;80,33;9352;4569;4783;116
1230;Torgelow, Stadt;17358;72,19;9349;4598;4751;130
1231;Heilsbronn, St;91560;62,23;9347;4616;4731;150
1232;Bad Breisig, Stadt;53498;19,93;9341;4520;4821;469
1233;Raguhn-Jeßnitz, Stadt;6779;97,13;9307;4601;4706;96
1234;Obernkirchen, Stadt;31683;32,45;9302;4649;4653;287
1235;Eisenberg (Pfalz), Stadt;67304;18,75;9301;4627;4674;496
1236;Miltenberg, St;63897;60,25;9298;4560;4738;154
1237;Altlandsberg, Stadt;15345;106,6;9298;4636;4662;87
1238;Töging a.Inn, St;84513;13,65;9286;4534;4752;680
1239;Bad Liebenwerda, Stadt;4924;138,88;9283;4549;4734;67
1240;Zahna-Elster, Stadt;6895;148,58;9278;4648;4630;62
1241;Bad Liebenzell, Stadt;75378;33,78;9249;4537;4712;274
1242;Lüchow (Wendland), Stadt;29439;89,46;9214;4474;4740;103
1243;Kyritz, Stadt;16866;157,38;9192;4502;4690;58
1244;Bad Bevensen, Stadt;29549;48,36;9190;4230;4960;190
1245;Doberlug-Kirchhain, Stadt;3253;150,36;9179;4586;4593;61
1246;Wunsiedel, St;95632;54,88;9172;4455;4717;167
1247;Heiligenhafen, Stadt;23774;18,32;9162;4428;4734;500
1248;Herzberg (Elster), Stadt;4916;149;9129;4375;4754;61
1249;Osthofen, Stadt;67574;18,62;9128;4518;4610;490
1250;Elsfleth, Stadt;26931;115,19;9117;4661;4456;79
1251;Zwenkau, Stadt;4442;46,3;9082;4465;4617;196
1252;Ortenberg, Stadt;63683;54,69;9076;4473;4603;166
1253;Storkow (Mark), Stadt;15859;180,72;9070;4534;4536;50
1254;Wertingen, St;86637;51,88;9042;4493;4549;174
1255;Ballenstedt, Stadt;6493;86,65;9033;4412;4621;104
1256;Reinfeld (Holstein), Stadt;23858;17,36;9029;4470;4559;520
1257;Furtwangen im Schwarzwald, Stadt;78120;82,57;9025;4651;4374;109
1258;Kandel, Stadt;76870;26,69;9003;4448;4555;337
1259;Waldheim, Stadt;4736;41,71;9002;4582;4420;216
1260;Tecklenburg, Stadt;49545;70,49;8989;4506;4483;128
1261;Weißenthurm, Stadt;56575;3,99;8981;4636;4345;2249
1262;Bad Frankenhausen/Kyffhäuser, Stadt;6567;66,22;8975;4418;4557;136
1263;Furth im Wald, St;93437;67,06;8960;4491;4469;134
1264;Penig, Stadt;9322;63,37;8953;4385;4568;141
1265;Mittenwalde, Stadt;15749;99,12;8950;4580;4370;90
1266;Olbernhau, Stadt;9526;70,22;8944;4369;4575;127
1267;Mücheln (Geiseltal), Stadt;6249;98,58;8939;4443;4496;91
1268;Mansfeld, Stadt;6343;143,8;8929;4454;4475;62
1269;Breckerfeld, Hansestadt;58339;59,1;8920;4401;4519;151
1270;Hemau, St;93155;122,33;8907;4559;4348;73
1271;Freystadt, St;92342;80,56;8904;4582;4322;111
1272;Plön, Stadt;24306;36,73;8903;4280;4623;242
1273;Rain, St;86641;77,13;8902;4484;4418;115
1274;Calbe (Saale), Stadt;39240;56,67;8902;4292;4610;157
1275;Wetter (Hessen), Stadt;35083;104,56;8901;4503;4398;85
1276;Bad Griesbach i.Rottal, St;94086;70,13;8901;4385;4516;127
1277;Laufenburg (Baden), Stadt;79725;23,55;8884;4348;4536;377
1278;Auerbach i.d.OPf., St;91275;78,25;8859;4369;4490;113
1279;Elze, Stadt;31008;47,81;8853;4367;4486;185
1280;Bad Lauchstädt, Goethestadt;6246;85,37;8851;4372;4479;104
1281;Lauter-Bernsbach, Stadt;8315;30,28;8846;4308;4538;292
1282;Borgholzhausen, Stadt;33829;55,99;8835;4381;4454;158
1283;Ichenhausen, St;89335;34,27;8811;4478;4333;257
1284;Ochsenhausen, Stadt;88416;59,96;8808;4477;4331;147
1285;Mendig, Stadt;56743;23,75;8803;4384;4419;371
1286;Tirschenreuth, St;95643;103,95;8787;4242;4545;85
1287;Volkach, St;97332;60,19;8784;4358;4426;146
1288;Nittenau, St;93149;98,73;8725;4447;4278;88
1289;Colditz, Stadt;4680;84,09;8720;4281;4439;104
1290;Florstadt, Stadt;61197;39,6;8699;4303;4396;220
1291;Ueckermünde, Stadt;17373;85,87;8696;4248;4448;101
1292;Weida, Stadt;7570;36,8;8694;4280;4414;236
1293;Hemmoor, Stadt;21745;45,07;8690;4231;4459;193
1294;Kappeln, Stadt;24376;43,32;8676;4175;4501;200
1295;Klingenthal, Stadt;8248;50,44;8674;4209;4465;172
1296;Waldenbuch, Stadt;71111;22,7;8670;4254;4416;382
1297;Barth, Stadt;18356;41,18;8660;4139;4521;210
1298;Obernburg a.Main, St;63785;24,82;8647;4260;4387;348
1299;Schieder-Schwalenberg, Stadt;32816;60,04;8645;4296;4349;144
1300;Naunhof, Stadt;4683;39,72;8639;4223;4416;218
1301;Großräschen, Stadt;1983;81,86;8629;4239;4390;105
1302;Rauenberg, Stadt;69231;11,12;8627;4288;4339;776
1303;Barntrup, Stadt;32683;59,46;8616;4299;4317;145
1304;Kirchen (Sieg), Stadt;57548;39,76;8613;4241;4372;217
1305;Lützen, Stadt;6686;96,49;8612;4267;4345;89
1306;Hainichen, Stadt;9661;51,74;8609;4295;4314;166
1307;Neuötting, St;84524;36,6;8601;4191;4410;235
1308;Werneuchen, Stadt;16356;117,01;8584;4309;4275;73
1309;Lößnitz, Stadt;8294;30,49;8559;4172;4387;281
1310;Borgentreich, Orgelstadt4);34434;138,94;/;/;/;/
1311;Bad Schussenried, Stadt;88427;55,01;8553;4334;4219;155
1312;Berching, St;92334;131,18;8541;4302;4239;65
1313;Barby, Stadt;39249;152,76;8535;4240;4295;56
1314;Teterow, Stadt;17166;47,07;8524;4169;4355;181
1315;Könnern, Stadt;6420;125,28;8519;4247;4272;68
1316;Schleiz, Stadt;7907;83,15;8509;4247;4262;102
1317;Lauta, Stadt;2991;42,13;8504;4156;4348;202
1318;Oranienbaum-Wörlitz, Stadt;6785;115,16;8493;4332;4161;74
1319;Bad Sooden-Allendorf, Stadt;37242;73,52;8476;4163;4313;115
1320;Vallendar, Stadt;56179;13,22;8443;4097;4346;638
1321;Wissen, Stadt;57537;34,88;8437;4193;4244;242
1322;Bersenbrück, Stadt;49593;42,54;8436;4176;4260;198
1323;Helmbrechts, St;95233;58,72;8425;4101;4324;143
1324;Premnitz, Stadt;14727;46,27;8423;4064;4359;182
1325;Großbottwar, Stadt;71723;25,51;8408;4218;4190;330
1326;Bad Schmiedeberg, Stadt;6905;160,02;8399;4158;4241;52
1327;Kirchberg, Stadt;8107;39,57;8395;4028;4367;212
1328;Leisnig, Stadt;4703;78,08;8392;4083;4309;107
1329;Nierstein, Stadt;55283;19,34;8388;4135;4253;434
1330;Hallstadt, St;96103;14,6;8356;4123;4233;572
1331;Kandern, Stadt;79400;62,26;8347;4102;4245;134
1332;Meßkirch, Stadt;88605;76,22;8347;4203;4144;110
1333;Bismark (Altmark), Stadt;39629;289,45;8335;4181;4154;29
1334;Dannenberg (Elbe), Stadt;29451;76,62;8330;4161;4169;109
1335;Staufenberg, Stadt;35460;28,6;8314;4091;4223;291
1336;Vetschau/Spreewald, Stadt;3226;111,51;8297;4178;4119;74
1337;Grafenau, St;94481;63,73;8276;4112;4164;130
1338;Landstuhl, Sickingenstadt, Stadt;66849;15,34;8276;4081;4195;539
1339;Willebadessen, Stadt;34439;128,41;8241;4175;4066;64
1340;Falkenstein/Vogtl., Stadt;8223;31,06;8235;3909;4326;265
1341;Kuppenheim, Stadt;76456;18,08;8228;3995;4233;455
1342;Vohburg a.d.Donau, St;85088;45,18;8216;4235;3981;182
1343;Kirn, Stadt;55606;16,53;8191;3975;4216;496
1344;Teuchern, Stadt;6682;81,36;8176;4087;4089;100
1345;Bad Bergzabern, Stadt;76887;10,71;8164;3865;4299;762
1346;Rheinsberg, Stadt;16831;328,22;8161;4094;4067;25
1347;Neustadt an der Orla, Stadt;7806;36,73;8158;3957;4201;222
1348;Lugau/Erzgeb., Stadt;9385;22,29;8147;3936;4211;365
1349;Neunburg vorm Wald, St;92431;110,14;8133;4178;3955;74
1350;Seeland, Stadt;6469;78,86;8130;4061;4069;103
1351;Viechtach, St;94234;62,47;8130;4042;4088;130
1352;Elsterwerda, Stadt;4910;40,58;8118;3962;4156;200
1353;Beeskow, Stadt;15848;77,81;8099;3892;4207;104
1354;Arnstein, St;97450;112,1;8090;4095;3995;72
1355;Staufen im Breisgau, Stadt;79219;23,32;8085;3850;4235;347
1356;Bad Lausick, Stadt;4651;70,02;8081;3966;4115;115
1357;Oederan, Stadt;9569;77,33;8079;4007;4072;104
1358;Altenberg, Stadt;1773;145,89;8060;4057;4003;55
1359;Zell am Harmersbach, Stadt;77736;36,41;8034;3978;4056;221
1360;Kellinghusen, Stadt;25548;18,81;8020;3960;4060;426
1361;Möckmühl, Stadt;74219;49,6;8011;4099;3912;162
1362;Neuenbürg, Stadt;75305;28,15;7999;3992;4007;284
1363;Dornstetten, Stadt;72280;24,2;7995;3957;4038;330
1364;Treuen, Stadt;8233;43,74;7993;3903;4090;183
1365;Bad Düben, Stadt;4849;45,83;7968;3836;4132;174
1366;Daun, Stadt;54550;49,02;7964;3894;4070;162
1367;Wörrstadt, Stadt;55286;16,75;7946;3927;4019;474
1368;Knittlingen, Stadt;75438;26,33;7928;3901;4027;301
1369;Rottenburg a.d.Laaber, St;84056;90,11;7924;3993;3931;88
1370;Simmern/ Hunsrück, Stadt;55469;11,96;7914;3799;4115;662
1371;Neresheim, Stadt;73450;118,51;7910;4074;3836;67
1372;Kühlungsborn, Stadt;18225;16,17;7909;3758;4151;489
1373;Medebach, Hansestadt;59964;126,05;7906;3973;3933;63
1374;Harzgerode, Stadt;6493;164,66;7906;3965;3941;48
1375;Herrieden, St;91567;81,66;7895;3933;3962;97
1376;Bützow, Stadt;18246;39,85;7887;4046;3841;198
1377;Bad Liebenstein, Stadt;36448;48,81;7884;3806;4078;162
1378;Pockau-Lengefeld, Stadt;9514;83,43;7848;3924;3924;94
1379;Schweich, Stadt;54338;31,1;7840;3718;4122;252
1380;Allstedt, Stadt;6542;149,81;7839;3931;3908;52
1381;Calau, Stadt;3205;163,5;7836;3908;3928;48
1382;Belgern-Schildau, Stadt;4874;158,98;7828;3927;3901;49
1383;Kirchheimbolanden, Stadt;67292;26,36;7790;3760;4030;296
1384;Oberkochen, Stadt;73447;23,55;7785;3829;3956;331
1385;Gundelfingen a.d.Donau, St;89423;54,06;7763;3869;3894;144
1386;Aken (Elbe), Stadt;6385;59,91;7754;3799;3955;129
1387;Bad Herrenalb, Stadt;76332;33,01;7745;3805;3940;235
1388;Bönnigheim, Stadt;74357;20,13;7725;3823;3902;384
1389;Hermsdorf, Stadt;7629;7,49;7724;3746;3978;1031
1390;Naila, St;95119;37,04;7715;3721;3994;208
1391;Löffingen, Stadt;79843;88,02;7698;3887;3811;87
1392;Markneukirchen, Stadt;8258;69,07;7696;3769;3927;111
1393;Hardegsen, Stadt;37181;84,03;7694;3765;3929;92
1394;Kalbe (Milde), Stadt;39624;272,7;7689;3905;3784;28
1395;Ramstein-Miesenbach, Stadt;66877;43,01;7677;3756;3921;178
1396;Sontra, Stadt;36205;111,29;7671;3857;3814;69
1397;Hüfingen, Stadt;78183;58,55;7635;3802;3833;130
1398;Münnerstadt, St;97702;93,11;7624;3894;3730;82
1399;Gerolstein, Stadt;54568;64,43;7613;3802;3811;118
1400;Ransbach-Baumbach, Stadt;56235;12,15;7578;3692;3886;624
1401;Roßwein, Stadt;4741;44,1;7571;3797;3774;172
1402;Baiersdorf, St;91083;11,81;7560;3738;3822;640
1403;Bad Berka, Stadt;99438;55,32;7540;3651;3889;136
1404;Eibenstock, Stadt;8309;112,22;7536;3727;3809;67
1405;Pulsnitz, Stadt;1896;26,75;7515;3676;3839;281
1406;Groitzsch, Stadt;4539;70,17;7496;3603;3893;107
1407;Bad Sachsa, Stadt;37441;33,2;7476;3622;3854;225
1408;Friedrichroda, Stadt;99894;36,88;7471;3619;3852;203
1409;Bad Kötzting, St;93444;62,15;7462;3662;3800;120
1410;Treuenbrietzen, Stadt;14929;212,43;7460;3679;3781;35
1411;Malchin, Stadt;17139;95;7456;3697;3759;78
1412;Gedern, Stadt;63688;75,24;7441;3780;3661;99
1413;Homberg (Ohm), Stadt;35315;88,02;7423;3746;3677;84
1414;Oppenheim, Stadt;55276;7,1;7417;3564;3853;1045
1415;Breuberg, Stadt;64747;30,76;7413;3657;3756;241
1416;Vohenstrauß, St;92648;74,91;7390;3613;3777;99
1417;Weikersheim, Stadt;97990;80,93;7387;3667;3720;91
1418;Radeburg, Stadt;1471;54,01;7383;3704;3679;137
1419;Esens, Stadt;26427;21,67;7343;3441;3902;339
1420;Teublitz, St;93158;38,23;7343;3653;3690;192
1421;Ebern, St;96106;95,01;7333;3728;3605;77
1422;Wriezen, Stadt;16269;95,15;7331;3638;3693;77
1423;Kremmen, Stadt;16766;209,55;7310;3647;3663;35
1424;Saarburg, Stadt;54439;20,63;7308;3512;3796;354
1425;Heringen (Werra), Stadt;36266;61,17;7306;3609;3697;119
1426;Freyung, St;94078;48,63;7305;3619;3686;150
1427;Gundelsheim, Stadt;74831;38,44;7305;3654;3651;190
1428;Meldorf, Stadt;25704;21,26;7299;3501;3798;343
1429;Otterndorf, Stadt;21762;33,55;7283;3467;3816;217
1430;Dettelbach, St;97337;60,94;7280;3666;3614;119
1431;Gröditz, Stadt;1609;28,94;7266;3586;3680;251
1432;Elzach, Stadt;79215;75,28;7259;3594;3665;96
1433;Gerbstedt, Stadt;6347;102,31;7257;3620;3637;71
1434;Hartha, Stadt;4746;54,4;7227;3543;3684;133
1435;Renchen, Stadt;77871;32,08;7189;3593;3596;224
1436;Lengenfeld, Stadt;8485;46,98;7187;3540;3647;153
1437;Scheßlitz, St;96110;94,87;7157;3682;3475;75
1438;Hecklingen, Stadt;39444;95,34;7146;3520;3626;75
1439;Schwarzenbach a.d.Saale, St;95126;59,18;7116;3502;3614;120
1440;Annweiler am Trifels, Stadt;76855;39,87;7113;3529;3584;178
1441;Laufen, St;83410;35,28;7109;3595;3514;202
1442;Neukirchen, Stadt;34626;66,26;7108;3584;3524;107
1443;Greding, St;91171;103,74;7088;3608;3480;68
1444;Haslach im Kinzigtal, Stadt;77716;18,67;7086;3494;3592;379
1445;Bernkastel-Kues, Stadt;54470;23,71;7057;3387;3670;298
1446;Zwingenberg, Stadt;64673;5,66;7031;3527;3504;1243
1447;Leipheim, St;89340;32,15;7007;3625;3382;218
1448;Jerichow, Stadt;39319;269,93;6999;3530;3469;26
1449;Bad Wimpfen, Stadt;74206;19,38;6985;3469;3516;360
1450;Moringen, Stadt;37186;82,39;6970;3577;3393;85
1451;Parsberg, St;92331;57,32;6955;3537;3418;121
1452;Römhild, Stadt;98630;122,45;6946;3503;3443;57
1453;Immenhausen, Stadt;34376;28,54;6936;3440;3496;243
1454;Birkenfeld, Stadt;55765;13,64;6923;3483;3440;508
1455;Gerolzhofen, St;97447;18,39;6908;3389;3519;376
1456;Geiselhöring, St;94333;99,69;6900;3498;3402;69
1457;Rodalben, Stadt;66976;15,69;6892;3392;3500;439
1458;Schelklingen, Stadt;89601;75,85;6880;3493;3387;91
1459;Kahla, Stadt;7768;7,89;6875;3351;3524;871
1460;Volkmarsen, Stadt;34471;67,47;6871;3450;3421;102
1461;Ebermannstadt, St;91320;49,95;6851;3392;3459;137
1462;Arendsee (Altmark), Stadt;39619;269,68;6850;3419;3431;25
1463;Neuhaus am Rennweg, Stadt;98724;80,98;6846;3424;3422;85
1464;Annaburg, Stadt;6925;224,28;6843;3398;3445;31
1465;Bonndorf im Schwarzwald, Stadt;79848;75,91;6834;3491;3343;90
1466;Neustadt-Glewe, Stadt;19306;94,14;6824;3474;3350;72
1467;Waldeck, Stadt;34513;115,73;6822;3397;3425;59
1468;Müncheberg, Stadt;15374;152,29;6820;3468;3352;45
1469;Waldmünchen, St;93449;101,17;6812;3359;3453;67
1470;Reichelsheim (Wetterau), Stadt;61203;27,6;6809;3395;3414;247
1471;Polch, Stadt;56751;28,68;6807;3421;3386;237
1472;Böhlen, Stadt;4564;24,56;6805;3352;3453;277
1473;Arnstein, Stadt;6333;121,69;6790;3382;3408;56
1474;Waldsassen, St;95652;66,53;6767;3362;3405;102
1475;Gau-Algesheim, Stadt;55435;13,99;6754;3266;3488;483
1476;Glashütte, Stadt;1768;95,64;6751;3412;3339;71
1477;Edenkoben, Stadt;67480;17,89;6742;3374;3368;377
1478;Dietenheim, Stadt;89165;18,75;6742;3349;3393;360
1479;Nortorf, Stadt;24589;12,77;6701;3242;3459;525
1480;Friedland, Stadt;17098;132,66;6679;3311;3368;50
1481;Bad Blankenburg, Stadt;7422;35,62;6666;3291;3375;187
1482;Höchstädt a.d.Donau, St;89420;37,45;6663;3320;3343;178
1483;Havelberg, Hansestadt;39539;149,12;6646;3296;3350;45
1484;Boxberg, Stadt;97944;101,71;6633;3386;3247;65
1485;Mitterteich, St;95666;39,38;6630;3260;3370;168
1486;Herdorf, Stadt;57562;17,99;6620;3247;3373;368
1487;Großröhrsdorf, Stadt;1900;26,54;6614;3221;3393;249
1488;Königsee-Rottenbach, Stadt;7426;84,37;6603;3306;3297;78
1489;Zierenberg, Stadt;34289;86,53;6600;3250;3350;76
1490;Malchow, Stadt;17213;44,71;6556;3166;3390;147
1491;Bernsdorf, Stadt;2994;59,78;6533;3211;3322;109
1492;Neuenstein, Stadt;74632;47,84;6498;3313;3185;136
1493;Rodewisch, Stadt;8228;26,88;6491;3191;3300;242
1494;Maulbronn, Stadt;75433;25,44;6490;3182;3308;255
1495;Osterburken, Stadt;74706;47,32;6485;3264;3221;137
1496;Ketzin/Havel, Stadt;14669;93,63;6474;3230;3244;69
1497;Falkenberg/Elster, Stadt;4895;82,16;6459;3203;3256;79
1498;Ilshofen, Stadt;74532;54,87;6459;3297;3162;118
1499;Burgkunstadt, St;96224;40,6;6455;3100;3355;159
1500;Großalmerode, Stadt;37247;37,62;6445;3154;3291;171
1501;Bad Sobernheim, Stadt;55566;54,18;6441;3155;3286;119
1502;Rosenfeld, Stadt;72348;51,11;6407;3223;3184;125
1503;Blankenhain, Stadt;99444;113,75;6406;3164;3242;56
1504;Beerfelden, Stadt;64743;71,19;6405;3213;3192;90
1505;Horstmar, Stadt der Burgmannshöfe;48612;44,76;6402;3238;3164;143
1506;Trochtelfingen, Stadt;72818;79,2;6377;3237;3140;81
1507;Rodenberg, Stadt;31552;15,62;6376;3167;3209;408
1508;Gammertingen, Stadt;72501;52,97;6367;3298;3069;120
1509;Wittenburg, Stadt;19243;80,08;6355;3259;3096;79
1510;Bad Brückenau, St;97769;23,71;6352;3113;3239;268
1511;Bad Rodach, St;96476;77,65;6352;3141;3211;82
1512;Nienburg (Saale), Stadt;6429;79,14;6341;3136;3205;80
1513;Grafenwöhr, St;92655;216,21;6336;3118;3218;29
1514;Uffenheim, St;97215;59,46;6332;3126;3206;106
1515;Schirgiswalde-Kirschau, Stadt;2681;24,34;6331;3175;3156;260
1516;Dohna, Stadt;1809;28,59;6325;3177;3148;221
1517;Alpirsbach, Stadt;72275;64,55;6291;3196;3095;97
1518;Thalheim/Erzgeb., Stadt;9380;10,79;6285;3038;3247;582
1519;Pegau, Stadt;4523;48,8;6284;3071;3213;129
1520;Güglingen, Stadt;74363;16,27;6269;3213;3056;385
1521;Altenkirchen (Westerwald), Stadt;57610;10,98;6256;2985;3271;570
1522;Spangenberg, Liebenbachstadt;34286;97,7;6241;3217;3024;64
1523;Neuffen, Stadt;72639;17,43;6234;3127;3107;358
1524;Zell im Wiesental, Stadt;79669;36,12;6226;3087;3139;172
1525;Nieheim, Stadt;33039;79,71;6222;3215;3007;78
1526;Beilstein, Stadt;71717;25,24;6212;3097;3115;246
1527;Geisingen, Stadt;78187;73,75;6211;3164;3047;84
1528;Neumarkt-Sankt Veit, St;84494;61,07;6204;3107;3097;102
1529;Lübz, Stadt;19386;57,73;6197;2986;3211;107
1530;Bleicherode, Stadt;99752;28,32;6157;3031;3126;217
1531;Heitersheim, Stadt;79423;11,71;6156;3030;3126;526
1532;Hermeskeil, Stadt;54411;30,89;6136;3044;3092;199
1533;Stavenhagen, Reuterstadt, Stadt;17153;41,02;6127;3078;3049;149
1534;Klingenberg a.Main, St;63911;21,12;6125;3065;3060;290
1535;Brotterode-Trusetal, Stadt;98596;49,68;6109;3009;3100;123
1536;Dietfurt a.d.Altmühl, St;92345;78,71;6094;3192;2902;77
1537;Plau am See, Stadt;19395;116,27;6076;2970;3106;52
1538;Windsbach, St;91575;68,12;6076;3140;2936;89
1539;Mügeln, Stadt;4769;55,08;6076;3001;3075;110
1540;Nabburg, St;92507;62,38;6067;3018;3049;97
1541;Thannhausen, St;86470;20,03;6067;2950;3117;303
1542;Braunlage, Stadt;38700;31,65;6049;3033;3016;191
1543;Kölleda, Stadt;99625;70,4;6042;2991;3051;86
1544;Herrnhut, Stadt;2747;74,12;6033;2978;3055;81
1545;Bad Lobenstein, Stadt;7356;48,92;6029;2991;3038;123
1546;Wassertrüdingen, St;91717;53,57;6023;3013;3010;112
1547;Rötha, Stadt;4571;46,16;6016;3066;2950;130
1548;Bad Königshofen i.Grabfeld, St;97631;69,51;6000;2914;3086;86
1549;Grünhain-Beierfeld, Stadt;8344;22,25;5999;2983;3016;270
1550;Glücksburg (Ostsee), Stadt;24960;39,7;5995;2859;3136;151
1551;Dornhan, Stadt;72175;44,92;5988;3011;2977;133
1552;Norderney, Stadt;26548;26,31;5981;2840;3141;227
1553;Linz am Rhein, Stadt;53545;17,98;5962;2855;3107;332
1554;Vilseck, St;92249;64,69;5937;2933;3004;92
1555;Oberlungwitz, Stadt;9353;14,68;5934;2891;3043;404
1556;Hachenburg, Stadt;57627;21,43;5932;2793;3139;277
1557;Geislingen, Stadt;72351;31,96;5919;2983;2936;185
1558;Gransee, Stadt;16775;121,68;5895;2962;2933;48
1559;Stadtroda, Stadt;7646;16,76;5893;2878;3015;352
1560;Riedenburg, St;93339;100,3;5891;2988;2903;59
1561;Vogtsburg im Kaiserstuhl, Stadt;79235;37,36;5882;2970;2912;157
1562;Bad Marienberg (Westerwald), Stadt;56470;9,95;5877;2897;2980;590
1563;Fürstenberg/Havel, Stadt;16798;213,85;5874;2908;2966;27
1564;Bad Hönningen, Stadt;53557;20,09;5837;2860;2977;290
1565;Rochlitz, Stadt;9306;23,76;5832;2782;3050;245
1566;Schlüsselfeld, St;96132;70,24;5823;2973;2850;83
1567;Tittmoning, St;84529;72,01;5818;2968;2850;81
1568;Hausach, Stadt;77756;36,07;5809;2908;2901;161
1569;Leun, Stadt;35638;28,66;5800;2905;2895;202
1570;Grebenstein, Stadt;34393;49,85;5799;2871;2928;116
1571;Marne, Stadt;25709;4,83;5796;2757;3039;1200
1572;Neustadt a.d.Waldnaab, St;92660;9,93;5795;2865;2930;583
1573;Meersburg, Stadt;88709;12,07;5788;2759;3029;479
1574;Hirschau, St;92242;74,96;5783;2842;2941;77
1575;Bräunlingen, Stadt;78199;62,14;5779;2888;2891;93
1576;Wemding, St;86650;31,6;5777;2821;2956;183
1577;Haiterbach, Stadt;72221;28,92;5774;2874;2900;200
1578;Wittichenau, Stadt;2997;61,02;5770;2811;2959;95
1579;Wolfach, Stadt;77709;67,97;5762;2883;2879;85
1580;Stadtoldendorf, Stadt;37627;24,92;5760;2830;2930;231
1581;Waibstadt, Stadt;74915;25,57;5719;2804;2915;224
1582;Westerburg, Stadt;56457;18,48;5717;2755;2962;309
1583;Schwarzheide, Stadt;1987;33,44;5711;2825;2886;171
1584;Dierdorf, Stadt;56269;31,98;5691;2827;2864;178
1585;Traben-Trarbach, Stadt;56841;31,35;5687;2821;2866;181
1586;Grabow, Stadt;19300;72,27;5684;2811;2873;79
1587;Großschirma, Stadt;9603;61,63;5678;2843;2835;92
1588;Biesenthal, Stadt;16359;60,92;5671;2807;2864;93
1589;Mellrichstadt, St;97638;55,99;5667;2824;2843;101
1590;Stolpen, Stadt;1833;60,89;5666;2833;2833;93
1591;Bad Gottleuba-Berggießhübel, Stadt;1816;88,72;5660;2823;2837;64
1592;Schrozberg, Stadt;74575;105,21;5654;2909;2745;54
1593;Eisfeld, Stadt;98673;52,68;5636;2841;2795;107
1594;Drebkau, Stadt;3116;143,91;5610;2844;2766;39
1595;Ruhla, Stadt;99842;38,55;5605;2758;2847;145
1596;Münzenberg, Stadt;35516;31,63;5604;2763;2841;177
1597;Zeil a.Main, St;97475;35,72;5594;2756;2838;157
1598;Ellrich, Stadt;99755;69,43;5583;2770;2813;80
1599;Leutershausen, St;91578;84,07;5578;2789;2789;66
1600;Schöppenstedt, Stadt;38170;39,73;5561;2742;2819;140
1601;Abenberg, St;91183;48,41;5554;2709;2845;115
1602;Gersfeld (Rhön), Stadt;36129;89,37;5550;2758;2792;62
1603;Bodenwerder, Münchhausenstadt;37619;29,05;5547;2692;2855;191
1604;Neubulach, Stadt;75387;24,69;5536;2753;2783;224
1605;Artern/Unstrut, Stadt;6556;24,19;5533;2703;2830;229
1606;Ohrdruf, Stadt;99885;39,78;5520;2778;2742;139
1607;Laage, Stadt;18299;81,6;5511;2741;2770;68
1608;Harburg (Schwaben), St;86655;73,16;5508;2768;2740;75
1609;Gadebusch, Stadt;19205;47,76;5507;2698;2809;115
1610;Ingelfingen, Stadt;74653;46,48;5479;2708;2771;118
1611;Hagenbach, Stadt;76767;15,86;5475;2706;2769;345
1612;Seelow, Stadt;15306;42,73;5451;2636;2815;128
1613;Dornburg-Camburg, Stadt;7774;30,77;5450;2665;2785;177
1614;Pfreimd, St;92536;51,45;5448;2741;2707;106
1615;Bredstedt, Stadt;25821;9,75;5432;2673;2759;557
1616;Falkenstein/Harz, Stadt;6463;102,97;5419;2751;2668;53
1617;Prüm, Stadt;54595;22,87;5414;2734;2680;237
1618;Kemnath, St;95478;56,8;5398;2631;2767;95
1619;Schleusingen, Stadt;98553;36,88;5391;2649;2742;146
1620;Burg Stargard, Stadt;17094;76,61;5387;2641;2746;70
1621;Tharandt, Stadt;1737;71,22;5383;2722;2661;76
1622;Lütjenburg, Stadt;24321;6,15;5377;2606;2771;874
1623;Kastellaun, Stadt;56288;8,47;5361;2698;2663;633
1624;Niedenstein, Stadt;34305;30,61;5354;2734;2620;175
1625;Otterberg, Stadt;67697;32,11;5340;2596;2744;166
1626;Battenberg (Eder), Stadt;35088;64,73;5337;2670;2667;82
1627;Geithain, Stadt;4643;30,22;5336;2591;2745;177
1628;Thum, Stadt;9419;18,9;5328;2634;2694;282
1629;Uebigau-Wahrenbrück, Stadt;4938;135,61;5324;2697;2627;39
1630;Wirges, Stadt;56422;10,11;5323;2590;2733;526
1631;Altentreptow, Stadt;17087;53,08;5310;2576;2734;100
1632;Cochem, Stadt;56812;21,18;5310;2696;2614;251
1633;Velburg, St;92355;175,66;5310;2673;2637;30
1634;Pottenstein, St;91278;73,29;5257;2644;2613;72
1635;Eltmann, St;97483;40,75;5256;2663;2593;129
1636;Kusel, Stadt;66869;14,37;5252;2565;2687;366
1637;Vacha, Stadt;36404;44,41;5237;2578;2659;118
1638;Rockenhausen, Stadt;67806;36,83;5233;2581;2652;142
1639;Arzberg, St;95659;43,19;5231;2613;2618;121
1640;Diemelstadt, Stadt;34474;82,58;5229;2663;2566;63
1641;Külsheim, Stadt;97900;81,43;5218;2680;2538;64
1642;Munderkingen, Stadt;89597;13,07;5205;2568;2637;398
1643;Borkum, Stadt;26757;30,98;5189;2447;2742;167
1644;Neudenau, Stadt;74861;32,91;5186;2619;2567;158
1645;Heimsheim, Stadt;71296;14,3;5175;2829;2346;362
1646;Stühlingen, Stadt;79780;93,16;5143;2595;2548;55
1647;Amöneburg, Stadt;35287;43,95;5136;2570;2566;117
1648;Zarrentin am Schaalsee, Stadt;19246;91,91;5134;2588;2546;56
1649;Unkel, Stadt;53572;8,16;5127;2446;2681;628
1650;Erbendorf, St;92681;67,56;5115;2535;2580;76
1651;Oettingen i.Bay., St;86732;34,22;5107;2535;2572;149
1652;Röbel/Müritz, Stadt;17207;30,69;5106;2416;2690;166
1653;Lindenfels, Stadt;64678;21,09;5105;2551;2554;242
1654;Naumburg, Stadt;34311;66,29;5104;2513;2591;77
1655;Hofheim i.UFr., St;97461;56,34;5090;2524;2566;90
1656;Treffurt, Stadt;99830;54,77;5080;2520;2560;93
1657;Hollfeld, St;96142;80,65;5078;2497;2581;63
1658;Freinsheim, Stadt;67251;13,59;5072;2454;2618;373
1659;Marienmünster, Stadt;37696;64,36;5071;2540;2531;79
1660;Pausa-Mühltroff, Stadt;7952;64,13;5052;2505;2547;79
1661;Reichenbach/O.L., Stadt;2894;62,64;5047;2499;2548;81
1662;Adorf/Vogtl., Stadt;8626;42,92;5038;2433;2605;117
1663;Trendelburg, Stadt;34388;69,35;5036;2506;2530;73
1664;Freren, Stadt;49832;48,97;5033;2557;2476;103
1665;Wilthen, Stadt;2681;17,04;5032;2415;2617;295
1666;Forchtenberg, Stadt;74670;38,09;5022;2557;2465;132
1667;Windischeschenbach, St;92670;36,37;5020;2512;2508;138
1668;Ronneburg, Stadt;7580;19,13;5015;2425;2590;262
1669;Monheim, St;86653;69,33;5006;2567;2439;72
1670;Lommatzsch, Stadt;1623;66,63;5000;2437;2563;75
1671;Dahme/Mark, Stadt;15936;162,59;4994;2482;2512;31
1672;Adelsheim, Stadt;74740;43,84;4990;2654;2336;114
1673;Roßleben, Stadt;6571;33,57;4984;2434;2550;148
1674;Tönning, Stadt;25832;44,41;4976;2472;2504;112
1675;Seehausen (Altmark), Hansestadt;39615;107;4968;2430;2538;46
1676;Steinbach-Hallenberg, Kurort, Stadt;98587;22,64;4965;2396;2569;219
1677;Kitzscher, Stadt;4567;29,04;4964;2432;2532;171
1678;Mahlberg, Stadt;77972;16,59;4964;2490;2474;299
1679;Schwaan, Stadt;18258;38,28;4959;2447;2512;130
1680;Spalt, St;91174;55,67;4947;2481;2466;89
1681;Oberviechtach, St;92526;62,42;4931;2451;2480;79
1682;Hitzacker (Elbe), Stadt;29456;58,67;4921;2356;2565;84
1683;Lichtenau, Stadt;77839;27,61;4917;2458;2459;178
1684;Todtnau, Stadt;79674;69,75;4912;2431;2481;70
1685;Creußen, St;95473;60,47;4902;2432;2470;81
1686;Strasburg (Uckermark), Stadt;17335;87,47;4890;2391;2499;56
1687;Crivitz, Stadt;19089;75,87;4880;2335;2545;64
1688;Niederstetten, Stadt;97996;104,05;4820;2447;2373;46
1689;Weismain, St;96260;90,14;4816;2435;2381;53
1690;Herbstein, Stadt;36358;79,98;4815;2468;2347;60
1691;Heringen/Helme, Stadt;99765;66,91;4812;2423;2389;72
1692;Eggesin, Stadt;17367;88,23;4800;2348;2452;54
1693;Emmelshausen, Stadt;56281;7,9;4783;2308;2475;605
1694;Lübtheen, Stadt;19249;120,17;4780;2539;2241;40
1695;Kröpelin, Stadt;18236;67,54;4773;2361;2412;71
1696;Triberg im Schwarzwald, Stadt;78098;33,33;4764;2380;2384;143
1697;Bad Sulza, Stadt;99518;45,49;4762;2312;2450;105
1698;Ehrenfriedersdorf, Stadt;9427;15,89;4762;2300;2462;300
1699;Geisa, Stadt;36419;71,94;4745;2383;2362;66
1700;Wörth a.d.Donau, St;93086;52,25;4743;2433;2310;91
1701;Freyburg (Unstrut), Stadt;6632;46,55;4738;2304;2434;102
1702;Oppenau, Stadt;77728;72,98;4729;2382;2347;65
1703;Stadtilm, Stadt;99326;17,34;4719;2317;2402;272
1704;Bischofsheim a.d.Rhön, St;97653;67,7;4707;2314;2393;70
1705;Wachenheim an der Weinstraße, Stadt;67157;24,97;4706;2313;2393;189
1706;Lauchheim, Stadt;73466;40,86;4700;2386;2314;115
1707;Creglingen, Stadt;97993;117,23;4697;2370;2327;40
1708;Rothenburg/O.L., Stadt;2929;72,4;4673;2326;2347;65
1709;Groß-Bieberau, Stadt;64401;18,27;4667;2327;2340;255
1710;Wörth a.Main, St;63939;15,88;4652;2290;2362;293
1711;Schömberg, Stadt;72355;23,25;4651;2374;2277;200
1712;Hartenstein, Stadt;8118;36,7;4651;2247;2404;127
1713;Heideck, St;91180;58,64;4632;2356;2276;79
1714;Niederstotzingen, Stadt;89168;29,81;4631;2311;2320;155
1715;Dahn, Stadt;66994;40,76;4616;2248;2368;113
1716;Scheinfeld, St;91443;45,12;4613;2273;2340;102
1717;Iphofen, St;97346;78,06;4595;2266;2329;59
1718;Nassau, Stadt;56377;17,55;4586;2282;2304;261
1719;Müllrose, Stadt;15299;69,24;4571;2209;2362;66
1720;Krautheim, Stadt;74238;52,9;4563;2377;2186;86
1721;Augustusburg, Stadt;9573;23,38;4556;2263;2293;195
1722;Marlow, Stadt;18337;140,52;4553;2354;2199;32
1723;Tengen, Stadt;78250;62,04;4524;2234;2290;73
1724;Schwarzenbach a.Wald, St;95131;36,7;4505;2196;2309;123
1725;Hallenberg, Stadt;59969;65,35;4474;2280;2194;68
1726;Tann (Rhön), Stadt;36142;60,45;4445;2234;2211;74
1727;Schönau, Stadt;69250;22,49;4444;2223;2221;198
1728;Dargun, Stadt;17159;118,01;4432;2182;2250;38
1729;Gefrees, St;95482;50,32;4426;2146;2280;88
1730;Wilster, Stadt;25554;2,71;4420;2173;2247;1631
1731;Königsbrück, Stadt;1936;78,48;4416;2184;2232;56
1732;Rabenau, Stadt;1734;30,73;4406;2208;2198;143
1733;Kirchberg an der Jagst, Stadt;74592;40,93;4403;2362;2041;108
1734;Peitz, Stadt;3185;13,49;4400;2185;2215;326
1735;Schönberg, Stadt;23923;38,21;4398;2156;2242;115
1736;Lunzenau, Stadt;9328;28,33;4384;2150;2234;155
1737;Rauschenberg, Stadt;35282;67,33;4382;2145;2237;65
1738;Selbitz, St;95152;27,74;4375;2068;2307;158
1739;Woldegk, Stadt;17348;156,29;4360;2211;2149;28
1740;Waldkappel, Stadt;37284;96,48;4359;2193;2166;45
1741;Heimbach, Stadt;52396;64,96;4352;2209;2143;67
1742;Rennerod, Stadt;56477;18,14;4339;2213;2126;239
1743;Putbus, Stadt;18581;66,68;4334;2132;2202;65
1744;Loitz, Stadt;17121;89,9;4334;2117;2217;48
1745;Dahlen, Stadt;4774;71,87;4332;2132;2200;60
1746;Vellberg, Stadt;74541;31,89;4332;2159;2173;136
1747;Dransfeld, Stadt;37127;28,91;4327;2112;2215;150
1748;Bad Berneck i.Fichtelgebirge, St;95460;33,56;4326;2142;2184;129
1749;Dingelstädt, Stadt;37351;20,45;4324;2181;2143;211
1750;Pressath, St;92690;66,34;4316;2110;2206;65
1751;Gerabronn, Stadt;74582;40,38;4301;2159;2142;107
1752;Liebenwalde, Stadt;16559;142,17;4277;2166;2111;30
1753;Waldershof, St;95679;60,37;4264;2128;2136;71
1754;Geringswalde, Stadt;9326;30,06;4263;2096;2167;142
1755;Berka/Werra, Stadt;99837;57,09;4253;2146;2107;74
1756;Sternberg, Stadt;19406;67,7;4252;2024;2228;63
1757;Hornberg, Stadt;78132;54,45;4245;2123;2122;78
1758;Tambach-Dietharz/Thür. Wald, Stadt;99897;41,63;4243;2126;2117;102
1759;Penzlin, Stadt;17217;115,56;4212;2104;2108;36
1760;Güsten, Stadt;39439;36,16;4187;2061;2126;116
1761;Schnaittenbach, St;92253;63,41;4184;2112;2072;66
1762;Lichtenfels, Stadt;35104;96,73;4180;2152;2028;43
1763;Wyk auf Föhr, Stadt;25938;8;4159;1903;2256;520
1764;Wanfried, Stadt;37281;46,9;4151;2062;2089;89
1765;Allendorf (Lumda), Stadt;35469;22,01;4141;2099;2042;188
1766;Nastätten, Stadt;56355;13,05;4129;2008;2121;316
1767;Baruth/Mark, Stadt;15837;233,84;4121;2104;2017;18
1768;Elsterberg, Stadt;7985;25,1;4119;2007;2112;164
1769;Johanngeorgenstadt, Stadt;8349;29,58;4115;2008;2107;139
1770;Zell (Mosel), Stadt;56856;44,95;4106;2072;2034;91
1771;Bad Buchau, Stadt;88422;23,75;4093;2035;2058;172
1772;Dassow, Stadt;23942;66,98;4076;2071;2005;61
1773;Niedernhall, Stadt;74676;17,71;4068;2070;1998;230
1774;Neckarbischofsheim, Stadt;74924;26,4;4066;2032;2034;154
1775;Waldenburg, Stadt;8396;25,06;4060;2001;2059;162
1776;Rheinböllen, Stadt;55494;16,36;4058;2005;2053;248
1777;Pappenheim, St;91788;64,32;4057;2027;2030;63
1778;Gemünden (Wohra), Stadt;35285;58,67;4056;2075;1981;69
1779;Baunach, St;96148;32,14;4051;2084;1967;126
1780;St. Blasien, Stadt;79837;54,41;4037;1967;2070;74
1781;Gräfenberg, St;91322;37,83;4013;2038;1975;106
1782;Baumholder, Stadt;55774;69,19;4004;1910;2094;58
1783;Brück, Stadt;14822;86,19;3999;2084;1915;46
1784;Netzschkau, Stadt;8491;12,51;3989;1928;2061;319
1785;Amorbach, St;63916;50,9;3987;1949;2038;78
1786;Eschenbach i.d.OPf., St;92676;35,13;3986;1915;2071;113
1787;Lorch, Stadt;65391;54,53;3986;2037;1949;73
1788;Mirow, Stadt;17252;158,3;3978;1924;2054;25
1789;Lambrecht (Pfalz), Stadt;67466;8,32;3960;1919;2041;476
1790;Seßlach, St;96145;72,53;3939;2004;1935;54
1791;Steinach, Stadt;96523;26,35;3899;1892;2007;148
1792;Kirchberg (Hunsrück), Stadt;55481;18,05;3895;1921;1974;216
1793;Wolkenstein, Stadt;9429;30,51;3894;1912;1982;128
1794;Regis-Breitingen, Stadt;4565;26,37;3883;1978;1905;147
1795;Neukloster, Stadt;23992;27,51;3881;1955;1926;141
1796;Hoya, Stadt;27318;8,42;3880;1907;1973;461
1797;Neubukow, Stadt;18233;25,12;3878;1923;1955;154
1798;Neckarsteinach, Stadt;69239;17,23;3872;1943;1929;225
1799;Tessin, Stadt;18195;24,51;3855;1874;1981;157
1800;Trebsen/Mulde, Stadt;4687;35,03;3851;1910;1941;110
1801;Bad Karlshafen, Stadt;34385;14,85;3823;1939;1884;257
1802;Vöhrenbach, Stadt;78147;70,47;3820;1944;1876;54
1803;Schiltach, Stadt;77761;34,21;3818;1875;1943;112
1804;Mühlberg/Elbe, Stadt;4931;89,2;3813;1908;1905;43
1805;Deidesheim, Stadt;67146;26,54;3797;1829;1968;143
1806;Lucka, Stadt;4613;12,93;3790;1822;1968;293
1807;Gehren, Stadt;98708;43,79;3782;1905;1877;86
1808;Freudenberg, Stadt;97896;34,76;3782;1901;1881;109
1809;Marktbreit, St;97340;20,16;3757;1946;1811;186
1810;Strehla, Stadt;1616;30,28;3748;1835;1913;124
1811;Seifhennersdorf, Stadt;2782;19,12;3747;1837;1910;196
1812;Bad Elster, Stadt;8645;19,77;3723;1784;1939;188
1813;Triptis, Stadt;7819;33,15;3721;1820;1901;112
1814;Ellingen, St;91792;31,25;3713;1865;1848;119
1815;Ruhland, Stadt;1945;37,22;3693;1803;1890;99
1816;Tegernsee, St;83684;22,77;3692;1732;1960;162
1817;Bad Schandau, Stadt;1814;46,76;3682;1812;1870;79
1818;Grünsfeld, Stadt;97947;44,72;3678;1860;1818;82
1819;Schlotheim, Stadt;99994;22,4;3660;1781;1879;163
1820;Wildenfels, Stadt;8134;20,69;3657;1833;1824;177
1821;Königsberg i.Bay., St;97486;61,88;3653;1830;1823;59
1822;Tanna, Stadt;7922;87,35;3640;1804;1836;42
1823;Greußen, Stadt;99718;19,21;3618;1786;1832;188
1824;Bad Muskau, Stadt;2953;15,38;3612;1748;1864;235
1825;Auma-Weidatal, Stadt;7955;55,91;3606;1801;1805;64
1826;Bad Köstritz, Stadt;7586;16,93;3593;1717;1876;212
1827;Goldberg, Stadt;19399;64,72;3591;1745;1846;55
1828;Gröningen, Stadt;39397;59,68;3583;1786;1797;60
1829;Mühlheim an der Donau, Stadt;78570;21,74;3582;1788;1794;165
1830;Geyer, Stadt;9468;18,56;3554;1727;1827;191
1831;Welzow, Stadt;3119;39,57;3552;1749;1803;90
1832;Langewiesen, Stadt;98704;27,51;3544;1772;1772;129
1833;Münstermaifeld, Stadt;56294;27,77;3543;1751;1792;128
1834;Krakow am See, Stadt;18292;87,37;3501;1752;1749;40
1835;Rehna, Stadt;19217;44,59;3492;1737;1755;78
1836;Goldkronach, St;95497;23,24;3492;1714;1778;150
1837;Saalburg-Ebersdorf, Stadt;7929;72,05;3484;1719;1765;48
1838;Eschershausen, Stadt;37632;23,92;3469;1747;1722;145
1839;Weißensee, Stadt;99631;46,71;3462;1701;1761;74
1840;Hirschhorn (Neckar), Stadt;69434;30,86;3462;1719;1743;112
1841;Joachimsthal, Stadt;16247;121,73;3446;1743;1703;28
1842;Gößnitz, Stadt;4639;14,07;3444;1671;1773;245
1843;Rötz, St;92444;66,68;3438;1759;1679;52
1844;Ludwigsstadt, St;96337;58,75;3427;1700;1727;58
1845;Kelbra (Kyffhäuser), Stadt;6537;40,55;3424;1703;1721;84
1846;Neustadt (Dosse), Stadt;16845;75,87;3406;1663;1743;45
1847;Owen, Stadt;73277;9,7;3406;1712;1694;351
1848;Neusalza-Spremberg, Stadt;2742;22,91;3405;1673;1732;149
1849;Speicher, Stadt;54662;15,36;3396;1684;1712;221
1850;Bernstadt a. d. Eigen, Stadt;2748;52;3390;1688;1702;65
1851;Wasungen, Stadt;98634;29,51;3382;1701;1681;115
1852;Lauscha, Stadt;98724;18,72;3380;1663;1717;181
1853;Kranichfeld, Stadt;99448;23,1;3374;1675;1699;146
1854;Kaltennordheim, Stadt;36452;40,47;3363;1703;1660;83
1855;Berga/Elster, Stadt;7980;43,52;3359;1664;1695;77
1856;Ostheim v.d.Rhön, St;97645;40,85;3352;1679;1673;82
1857;Hohnstein, Stadt;1848;64,64;3335;1671;1664;52
1858;Egeln, Stadt;39435;29,14;3331;1640;1691;114
1859;Ulmen, Stadt;56766;28,74;3330;1654;1676;116
1860;Kirchenlamitz, St;95158;48,48;3294;1618;1676;68
1861;Döbern, Stadt;3159;15,79;3291;1574;1717;208
1862;Wesselburen, Stadt;25764;5,14;3287;1583;1704;639
1863;Oberriexingen, Stadt;71739;8,16;3286;1661;1625;403
1864;Löwenstein, Stadt;74245;23,46;3283;1656;1627;140
1865;Stromberg, Stadt;55442;9,01;3283;1585;1698;364
1866;Sonnewalde, Stadt;3249;119,29;3261;1667;1594;27
1867;Nebra (Unstrut), Stadt;6642;25,42;3249;1593;1656;128
1868;Havelsee, Stadt;14798;81,97;3244;1635;1609;40
1869;Warin, Stadt;19417;44,45;3244;1585;1659;73
1870;Lychen, Stadt;17279;111,99;3222;1561;1661;29
1871;Wurzbach, Stadt;7343;72,32;3215;1604;1611;44
1872;Kirtorf, Stadt;36320;79,91;3213;1623;1590;40
1873;Burgbernheim, St;91593;42,3;3198;1581;1617;76
1874;Schöneck/Vogtl., Stadt;8261;55,06;3198;1551;1647;58
1875;Schönwald, St;95173;19,19;3195;1542;1653;166
1876;Bärnau, St;95671;74,41;3179;1648;1531;43
1877;Kaisersesch, Stadt;56759;8,18;3168;1543;1625;387
1878;Hillesheim, Stadt;54576;20,66;3158;1557;1601;153
1879;Weißenberg, Stadt;2627;50,96;3153;1626;1527;62
1880;Weißenstadt, St;95163;42,23;3151;1538;1613;75
1881;Lebus, Stadt;15326;54,29;3145;1583;1562;58
1882;Stadtsteinach, St;95346;39,79;3139;1530;1609;79
1883;Fridingen an der Donau, Stadt;78567;22,47;3137;1565;1572;140
1884;Liebenau, Stadt;34396;48,87;3126;1511;1615;64
1885;Klütz, Stadt;23948;44,41;3116;1497;1619;70
1886;Marktleuthen, St;95168;35,48;3111;1525;1586;88
1887;Bad Teinach-Zavelstein, Stadt;75385;25,17;3103;1606;1497;123
1888;Prichsenstadt, St;97357;48,87;3088;1587;1501;63
1889;Schönewalde, Stadt;4916;156,18;3085;1609;1476;20
1890;Bürgel, Stadt;7616;27,19;3079;1532;1547;113
1891;Waischenfeld, St;91344;57,19;3069;1583;1486;54
1892;Hatzfeld (Eder), Stadt;35116;58,51;3061;1566;1495;52
1893;Wolframs-Eschenbach, St;91639;25,47;3060;1525;1535;120
1894;Dömitz, Stadt;19303;60,57;3046;1492;1554;50
1895;Gützkow, Stadt;17506;57,65;3042;1528;1514;53
1896;Wesenberg, Stadt;17255;89,64;3040;1508;1532;34
1897;Eibelstadt, St;97246;7,07;3035;1455;1580;429
1898;Braubach, Stadt;56338;19,5;3034;1522;1512;156
1899;Waldenburg, Stadt;74638;31,55;3030;1552;1478;96
1900;Lindow (Mark), Stadt;16835;65,47;3028;1552;1476;46
1901;Ulrichstein, Stadt;35327;65,61;3002;1525;1477;46
1902;Jarmen, Stadt;17126;30,71;2981;1498;1483;97
1903;Friedland, Stadt;15848;174,23;2975;1512;1463;17
1904;Münchenbernsdorf, Stadt;7589;15,45;2967;1441;1526;192
1905;Schalkau, Stadt;96528;33,57;2939;1469;1470;88
1906;Merkendorf, St;91732;26,07;2938;1489;1449;113
1907;Frankenau, Stadt;35110;57,29;2930;1474;1456;51
1908;Adenau, Stadt;53518;18,56;2925;1430;1495;158
1909;Rhens, Stadt;56321;16,31;2917;1426;1491;179
1910;Gnoien, Stadt;17179;41,11;2911;1432;1479;71
1911;Laucha an der Unstrut, Stadt;6636;31,14;2909;1471;1438;93
1912;Remda-Teichel, Stadt;7407;79,76;2902;1483;1419;36
1913;Elterlein, Stadt;9481;45,74;2900;1449;1451;63
1914;Themar, Stadt;98660;20,18;2899;1415;1484;144
1915;Frauenstein, Stadt;9623;59;2884;1466;1418;49
1916;Meisenheim, Stadt;55590;10,33;2858;1399;1459;277
1917;Wustrow (Wendland), Stadt;29462;30,19;2856;1426;1430;95
1918;Oberwesel, Stadt;55430;18,08;2843;1374;1469;157
1919;Ravenstein, Stadt;74747;55,97;2821;1452;1369;50
1920;Elstra, Stadt;1920;32,63;2807;1410;1397;86
1921;Schillingsfürst, St;91583;27,5;2800;1389;1411;102
1922;Bad Bibra, Stadt;6647;49,77;2797;1407;1390;56
1923;Selters (Westerwald), Stadt;56242;8,7;2792;1385;1407;321
1924;Jöhstadt, Stadt;9477;49,7;2756;1413;1343;55
1925;Wallenfels, St;96346;45,65;2747;1374;1373;60
1926;Sankt Goar, Stadt;56329;23,17;2743;1375;1368;118
1927;Putlitz, Stadt;16949;119,68;2736;1418;1318;23
1928;Romrod, Stadt;36329;54,43;2729;1349;1380;50
1929;Sulzburg, Stadt;79295;22,74;2701;1309;1392;119
1930;Tribsees, Stadt;18465;54,98;2636;1287;1349;48
1931;Garding, Stadt;25836;3,06;2627;1252;1375;858
1932;Ebeleben, Stadt;99713;40,74;2623;1323;1300;64
1933;Großbreitenbach, Stadt;98701;19,6;2615;1344;1271;133
1934;Wegeleben, Stadt;38828;51,78;2595;1319;1276;50
1935;Schkölen, Stadt;7619;53,43;2590;1322;1268;48
1936;Kohren-Sahlis, Stadt;4655;36,8;2589;1303;1286;70
1937;Alsleben (Saale), Stadt;6425;23,64;2586;1237;1349;109
1938;Bad Wilsnack, Stadt;19336;79,62;2577;1235;1342;32
1939;Golßen, Stadt;15938;63,68;2575;1279;1296;40
1940;Lauterstein, Stadt;73111;23,31;2571;1261;1310;110
1941;Brüel, Stadt;19412;27,21;2566;1265;1301;94
1942;Friesack, Stadt;14662;84,01;2560;1299;1261;30
1943;Friedrichstadt, Stadt;25840;4,03;2523;1190;1333;626
1944;Schwanebeck, Stadt;39397;32,66;2516;1233;1283;77
1945;Gartz (Oder), Stadt;16307;61,89;2515;1227;1288;41
1946;Bad Tennstedt, Stadt;99955;27,42;2505;1231;1274;91
1947;Dommitzsch, Stadt;4880;30,44;2503;1237;1266;82
1948;Scheer, Stadt;72516;18,72;2496;1276;1220;133
1949;Gefell, Stadt;7926;45,22;2491;1226;1265;55
1950;Betzenstein, St;91282;51,84;2485;1246;1239;48
1951;Buttstädt, Stadt;99628;18,36;2481;1235;1246;135
1952;Osterfeld, Stadt;6721;27,61;2481;1280;1201;90
1953;Rastenberg, Stadt;99636;35,52;2478;1247;1231;70
1954;Schönau im Schwarzwald, Stadt;79677;14,72;2448;1223;1225;166
1955;Schönsee, St;92539;50,28;2446;1223;1223;49
1956;Ziesar, Stadt;14793;67,95;2444;1196;1248;36
1957;Pleystein, St;92714;42,4;2427;1207;1220;57
1958;Schlieben, Stadt;4936;78,65;2422;1199;1223;31
1959;Stadtlengsfeld, Stadt;36457;27,7;2415;1229;1186;87
1960;Großenehrich, Stadt;99718;63,34;2406;1214;1192;38
1961;Eckartsberga, Stadt;6648;35,97;2402;1225;1177;67
1962;Grebenau, Stadt;36323;55,37;2401;1229;1172;43
1963;Schlettau, Stadt;9487;21,22;2397;1155;1242;113
1964;Krempe, Stadt;25361;3,39;2377;1166;1211;701
1965;Ostritz, Stadt;2899;23,48;2365;1160;1205;101
1966;Creuzburg, Stadt;99831;35,4;2359;1164;1195;67
1967;Rethem (Aller), Stadt;27336;34,03;2324;1144;1180;68
1968;Fladungen, St;97650;46,34;2316;1179;1137;50
1969;Aach, Stadt;78267;10,68;2270;1168;1102;213
1970;Heldrungen, Stadt;6577;23,27;2266;1110;1156;97
1971;Katzenelnbogen, Stadt;56368;9,18;2235;1077;1158;244
1972;Garz/Rügen, Stadt;18574;65,89;2220;1118;1102;34
1973;Rosenthal, Stadt;35119;51,54;2215;1112;1103;43
1974;Hayingen, Stadt;72534;63,36;2209;1133;1076;35
1975;Hirschberg, Stadt;7927;24,13;2186;1084;1102;91
1976;Oderberg, Stadt;16248;36,12;2185;1108;1077;60
1977;Lenzen (Elbe), Stadt;19309;96,19;2160;1049;1111;22
1978;Mainbernheim, St;97350;12,21;2157;1086;1071;177
1979;Oberwiesenthal, Kurort, Stadt;9484;40,02;2156;1049;1107;54
1980;Leutenberg, Stadt;7338;57,52;2149;1060;1089;37
1981;Ortrand, Stadt;1990;7,36;2144;1029;1115;291
1982;Rerik, Stadt;18230;34,22;2136;1012;1124;62
1983;Gebesee, Stadt;99189;24,08;2135;1064;1071;89
1984;Königstein/Sächs. Schw., Stadt;1824;27,05;2128;1075;1053;79
1985;Veringenstadt, Stadt;72519;31,25;2127;1071;1056;68
1986;Meyenburg, Stadt;16945;50,74;2126;1068;1058;42
1987;Scheibenberg, Stadt;9481;9;2126;1062;1064;236
1988;Lauterecken, Stadt;67742;8,89;2097;1015;1082;236
1989;Wiesensteig, Stadt;73349;23,41;2066;1057;1009;88
1990;Bad Colberg-Heldburg, Stadt;98663;53,39;2059;1052;1007;39
1991;Magdala, Stadt;99441;20,58;2033;1009;1024;99
1992;Niemegk, Stadt;14823;45,12;2031;1044;987;45
1993;Gräfenthal, Stadt;98743;36,42;2007;989;1018;55
1994;Teuschnitz, St;96358;34,25;1987;966;1021;58
1995;Rieneck, St;97794;26,19;1984;962;1022;76
1996;Wolfstein, Stadt;67752;13,75;1978;999;979;144
1997;Marktsteft, St;97342;10,51;1978;1030;948;188
1998;Sachsenhagen, Stadt;31553;15,29;1929;958;971;126
1999;Schauenstein, St;95197;26,66;1925;949;976;72
2000;Bacharach, Stadt;55422;23,35;1901;950;951;81
2001;Wiehe, Stadt;6571;24,51;1900;943;957;78
2002;Plaue, Stadt;99338;18,19;1896;945;951;104
2003;Brüssow, Stadt;17326;101,83;1883;945;938;18
2004;Kindelbrück, Stadt;99638;13,36;1877;929;948;141
2005;Penkun, Stadt;17328;78,88;1874;953;921;24
2006;Teupitz, Stadt;15755;48,15;1868;967;901;39
2007;Sayda, Stadt;9619;35,3;1865;922;943;53
2008;Velden, St;91235;21,34;1829;916;913;86
2009;Widdern, Stadt;74259;25,23;1815;937;878;72
2010;Langenburg, Stadt;74595;31,4;1813;930;883;58
2011;Usedom, Stadt;17406;38,98;1810;889;921;46
2012;Hettingen, Stadt;72513;46,06;1802;907;895;39
2013;Neukalen, Stadt;17154;47,97;1758;874;884;37
2014;Bad Sülze, Stadt;18334;26,66;1755;872;883;66
2015;Ranis, Stadt;7389;10,57;1720;829;891;163
2016;Röttingen, St;97285;27,21;1713;836;877;63
2017;Oberweißbach/Thür. Wald, Stadt;98744;9,65;1693;789;904;175
2018;Lehesten, Stadt;7349;35,94;1665;841;824;46
2019;Ornbau, St;91737;15,16;1646;834;812;109
2020;Oberhof, Stadt;98559;23,4;1625;792;833;69
2021;Rhinow, Stadt;14728;31,66;1614;809;805;51
2022;Stadt Wehlen, Stadt;1829;10,85;1609;821;788;148
2023;Neuerburg, Stadt;54673;10,17;1563;781;782;154
2024;Arneburg, Stadt;39596;30,64;1526;744;782;50
2025;Lassan, Stadt;17440;28,18;1513;779;734;54
2026;Stadtprozelten, St;97909;10,87;1496;770;726;138
2027;Buckow (Märkische Schweiz), Stadt;15377;14,42;1490;734;756;103
2028;Hohenleuben, Stadt;7958;9,53;1474;801;673;155
2029;Aub, St;97239;17,54;1474;756;718;84
2030;Hornbach, Stadt;66500;13,33;1469;745;724;110
2031;Kroppenstedt, Stadt;39397;38,65;1447;729;718;37
2032;Hohenberg a.d.Eger, St;95691;15,66;1422;701;721;91
2033;Franzburg, Stadt;18461;15,2;1394;673;721;92
2034;Schwarzenborn, Stadt;34639;26,9;1373;809;564;51
2035;Manderscheid, Stadt;54531;10,06;1373;654;719;136
2036;Lieberose, Stadt;15868;73,03;1360;678;682;19
2037;Liebstadt, Stadt;1825;37,36;1352;698;654;36
2038;Sankt Goarshausen, Loreleystadt, Stadt;56346;7,06;1338;672;666;190
2039;Richtenberg, Stadt;18461;15,68;1325;665;660;85
2040;Buttelstedt, Stadt;99439;18,85;1324;665;659;70
2041;Neustadt am Kulm, St;95514;20,3;1126;543;583;55
2042;Orlamünde, Stadt;7768;7,47;1120;550;570;150
2043;Schraplau, Stadt;6279;7,06;1118;549;569;158
2044;Werben (Elbe), Hansestadt;39615;53,37;1100;566;534;21
2045;Obermoschel, Stadt;67823;10,15;1045;524;521;103
2046;Kupferberg, St;95362;8,29;1042;527;515;126
2047;Lichtenberg, St;95192;9,47;1036;504;532;109
2048;Clingen, Stadt;99718;10,75;1021;502;519;95
2049;Rothenfels, St;97851;12,07;1001;517;484;83
2050;Stößen, Stadt;6667;7,29;916;430;486;126
2051;Kyllburg, Stadt;54655;4,62;886;450;436;192
2052;Sandau (Elbe), Stadt;39524;18,58;862;417;445;46
2053;Kaub, Stadt;56349;13,05;854;443;411;65
2054;Märkisch Buchholz, Stadt;15748;24,86;786;391;395;32
2055;Ziegenrück, Stadt;7924;8,25;660;317;343;80
2056;Schnackenburg, Stadt;29493;23,76;548;278;270;23
2057;Neumark, Stadt;99439;8,67;480;247;233;55
2058;Ummerstadt, Stadt;98663;15,73;474;246;228;30
2059;Arnis, Stadt;24399;0,45;275;143;132;611
;;;;;;;
;;;;;;;
;;;;;;;
;;;;;;;
;;;;;;;
;;;;;;;
;;;;;;;
;;;;;;;
;;;;;;;
